Rk,Team,Dateâ–²,PTS,,Opp,Result,MP,FG,FGA,FG%,2P,2PA,2P%,3P,3PA,3P%,FT,FTA,FT%,PTS,FG,FGA,FG%,2P,2PA,2P%,3P,3PA,3P%,FT,FTA,FT%,PTS
1,IND,2023-10-25,143,,WAS,W 143-120,240,56,107,.523,36,64,.563,20,43,.465,11,12,.917,143,44,96,.458,35,72,.486,9,24,.375,23,29,.793,120
2,BRK,2023-10-30,133,@,CHO,W 133-121,240,49,87,.563,37,54,.685,12,33,.364,23,32,.719,133,47,96,.490,39,65,.600,8,31,.258,19,20,.950,121
3,UTA,2023-11-01,133,,MEM,W 133-109,240,47,87,.540,25,44,.568,22,43,.512,17,24,.708,133,35,96,.365,21,42,.500,14,54,.259,25,32,.781,109
4,BOS,2023-11-01,155,,IND,W 155-104,240,54,95,.568,34,60,.567,20,35,.571,27,28,.964,155,46,101,.455,41,64,.641,5,37,.135,7,12,.583,104
5,OKC,2023-11-03,139,,GSW,L 139-141,240,50,83,.602,35,54,.648,15,29,.517,24,30,.800,139,49,92,.533,31,52,.596,18,40,.450,25,30,.833,141
6,GSW,2023-11-03,141,@,OKC,W 141-139,240,49,92,.533,31,52,.596,18,40,.450,25,30,.833,141,50,83,.602,35,54,.648,15,29,.517,24,30,.800,139
7,DEN,2023-11-06,134,,NOP,W 134-116,240,51,95,.537,36,56,.643,15,39,.385,17,23,.739,134,45,90,.500,32,60,.533,13,30,.433,13,15,.867,116
8,PHI,2023-11-06,146,,WAS,W 146-128,240,51,91,.560,39,60,.650,12,31,.387,32,36,.889,146,49,96,.510,35,62,.565,14,34,.412,16,20,.800,128
9,IND,2023-11-06,152,,SAS,W 152-111,240,55,95,.579,35,57,.614,20,38,.526,22,23,.957,152,40,94,.426,32,68,.471,8,26,.308,23,30,.767,111
10,IND,2023-11-08,134,,UTA,W 134-118,240,52,101,.515,39,60,.650,13,41,.317,17,20,.850,134,45,96,.469,34,69,.493,11,27,.407,17,18,.944,118
11,DAL,2023-11-10,144,,LAC,W 144-126,240,51,98,.520,32,56,.571,19,42,.452,23,26,.885,144,43,88,.489,35,61,.574,8,27,.296,32,36,.889,126
12,DAL,2023-11-12,136,@,NOP,W 136-124,240,50,102,.490,30,49,.612,20,53,.377,16,21,.762,136,47,92,.511,30,56,.536,17,36,.472,13,22,.591,124
13,PHI,2023-11-12,137,,IND,W 137-126,240,53,105,.505,39,72,.542,14,33,.424,17,20,.850,137,47,90,.522,31,51,.608,16,39,.410,16,19,.842,126
14,LAL,2023-11-14,134,,MEM,W 134-107,240,47,81,.580,25,46,.543,22,35,.629,18,24,.750,134,39,106,.368,19,53,.358,20,53,.377,9,12,.750,107
15,PHO,2023-11-15,133,,MIN,W 133-115,240,51,85,.600,34,54,.630,17,31,.548,14,15,.933,133,42,92,.457,37,65,.569,5,27,.185,26,28,.929,115
16,OKC,2023-11-19,134,@,POR,W 134-91,240,49,81,.605,27,45,.600,22,36,.611,14,14,1.000,134,34,85,.400,25,51,.490,9,34,.265,14,21,.667,91
17,UTA,2023-11-19,137,,PHO,L 137-140 (2OT),290,48,115,.417,33,69,.478,15,46,.326,26,32,.813,137,50,102,.490,32,57,.561,18,45,.400,22,26,.846,140
18,PHO,2023-11-19,140,@,UTA,W 140-137 (2OT),290,50,102,.490,32,57,.561,18,45,.400,22,26,.846,140,48,115,.417,33,69,.478,15,46,.326,26,32,.813,137
19,TOR,2023-11-19,142,,DET,W 142-113,240,55,102,.539,41,66,.621,14,36,.389,18,29,.621,142,39,83,.470,30,57,.526,9,26,.346,26,35,.743,113
20,MIL,2023-11-20,142,@,WAS,W 142-129,240,55,94,.585,44,65,.677,11,29,.379,21,28,.750,142,55,99,.556,45,70,.643,10,29,.345,9,11,.818,129
21,ATL,2023-11-21,152,,IND,L 152-157,240,57,95,.600,42,64,.656,15,31,.484,23,28,.821,152,57,94,.606,35,49,.714,22,45,.489,21,28,.750,157
22,IND,2023-11-21,157,@,ATL,W 157-152,240,57,94,.606,35,49,.714,22,45,.489,21,28,.750,157,57,95,.600,42,64,.656,15,31,.484,23,28,.821,152
23,BRK,2023-11-22,145,@,ATL,L 145-147 (OT),265,55,113,.487,40,78,.513,15,35,.429,20,24,.833,145,51,116,.440,33,67,.493,18,49,.367,27,29,.931,147
24,ATL,2023-11-22,147,,BRK,W 147-145 (OT),265,51,116,.440,33,67,.493,18,49,.367,27,29,.931,147,55,113,.487,40,78,.513,15,35,.429,20,24,.833,145
25,IND,2023-11-24,136,,DET,W 136-113,240,49,102,.480,33,64,.516,16,38,.421,22,24,.917,136,43,90,.478,36,72,.500,7,18,.389,20,24,.833,113
26,ATL,2023-11-25,136,@,WAS,W 136-108,240,52,102,.510,34,65,.523,18,37,.486,14,20,.700,136,43,88,.489,33,50,.660,10,38,.263,12,12,1.000,108
27,PHI,2023-11-27,138,,LAL,W 138-94,240,47,93,.505,25,47,.532,22,46,.478,22,26,.846,138,39,83,.470,32,55,.582,7,28,.250,9,13,.692,94
28,LAL,2023-11-29,133,@,DET,W 133-107,240,45,88,.511,33,54,.611,12,34,.353,31,38,.816,133,40,97,.412,25,61,.410,15,36,.417,12,14,.857,107
29,DEN,2023-11-29,134,,HOU,W 134-124,240,48,95,.505,29,52,.558,19,43,.442,19,26,.731,134,47,86,.547,31,45,.689,16,41,.390,14,19,.737,124
30,ORL,2023-11-29,139,,WAS,W 139-120,240,51,84,.607,34,57,.596,17,27,.630,20,24,.833,139,41,87,.471,30,58,.517,11,29,.379,27,35,.771,120
31,OKC,2023-11-30,133,,LAL,W 133-110,240,50,94,.532,36,52,.692,14,42,.333,19,22,.864,133,36,81,.444,25,48,.521,11,33,.333,27,32,.844,110
32,SAS,2023-11-30,135,,ATL,L 135-137,240,48,89,.539,30,48,.625,18,41,.439,21,23,.913,135,49,96,.510,35,63,.556,14,33,.424,25,29,.862,137
33,ATL,2023-11-30,137,@,SAS,W 137-135,240,49,96,.510,35,63,.556,14,33,.424,25,29,.862,137,48,89,.539,30,48,.625,18,41,.439,21,23,.913,135
34,MIA,2023-11-30,142,,IND,W 142-132,240,48,86,.558,40,65,.615,8,21,.381,38,45,.844,142,50,98,.510,39,55,.709,11,43,.256,21,32,.656,132
35,IND,2023-12-02,144,@,MIA,W 144-129,240,56,85,.659,40,53,.755,16,32,.500,16,20,.800,144,48,89,.539,36,64,.563,12,25,.480,21,24,.875,129
36,MIL,2023-12-05,146,,NYK,W 146-122,240,55,91,.604,32,53,.604,23,38,.605,13,19,.684,146,43,87,.494,36,64,.563,7,23,.304,29,33,.879,122
37,DAL,2023-12-06,147,,UTA,W 147-97,240,56,101,.554,34,52,.654,22,49,.449,13,19,.684,147,35,87,.402,23,54,.426,12,33,.364,15,18,.833,97
38,LAL,2023-12-07,133,,NOP,W 133-89,240,47,86,.547,30,51,.588,17,35,.486,22,29,.759,133,34,95,.358,27,64,.422,7,31,.226,14,20,.700,89
39,BOS,2023-12-08,133,,NYK,W 133-123,240,48,91,.527,29,44,.659,19,47,.404,18,21,.857,133,44,88,.500,29,51,.569,15,37,.405,20,27,.741,123
40,GSW,2023-12-08,136,@,OKC,L 136-138 (OT),265,49,104,.471,30,56,.536,19,48,.396,19,23,.826,136,51,98,.520,46,69,.667,5,29,.172,31,36,.861,138
41,OKC,2023-12-08,138,,GSW,W 138-136 (OT),265,51,98,.520,46,69,.667,5,29,.172,31,36,.861,138,49,104,.471,30,56,.536,19,48,.396,19,23,.826,136
42,MIL,2023-12-11,133,,CHI,W 133-129 (OT),265,44,86,.512,29,49,.592,15,37,.405,30,37,.811,133,47,114,.412,32,80,.400,15,34,.441,20,25,.800,129
43,OKC,2023-12-11,134,,UTA,W 134-120,240,50,96,.521,32,58,.552,18,38,.474,16,17,.941,134,44,92,.478,32,54,.593,12,38,.316,20,21,.952,120
44,NYK,2023-12-11,136,,TOR,W 136-130,240,52,86,.605,35,57,.614,17,29,.586,15,23,.652,136,47,96,.490,33,57,.579,14,39,.359,22,30,.733,130
45,PHI,2023-12-11,146,,WAS,W 146-101,240,52,95,.547,32,49,.653,20,46,.435,22,25,.880,146,36,85,.424,27,54,.500,9,31,.290,20,31,.645,101
46,TOR,2023-12-13,135,,ATL,W 135-128,240,50,87,.575,32,53,.604,18,34,.529,17,24,.708,135,48,100,.480,30,59,.508,18,41,.439,14,19,.737,128
47,MIL,2023-12-13,140,,IND,W 140-126,240,48,89,.539,41,62,.661,7,27,.259,37,48,.771,140,45,100,.450,34,64,.531,11,36,.306,25,32,.781,126
48,NOP,2023-12-13,142,@,WAS,W 142-122,240,50,96,.521,34,62,.548,16,34,.471,26,30,.867,142,42,82,.512,23,38,.605,19,44,.432,19,24,.792,122
49,WAS,2023-12-15,137,,IND,W 137-123,240,52,92,.565,39,65,.600,13,27,.481,20,26,.769,137,48,107,.449,33,67,.493,15,40,.375,12,16,.750,123
50,NYK,2023-12-15,139,@,PHO,W 139-122,240,49,82,.598,32,53,.604,17,29,.586,24,28,.857,139,47,90,.522,36,62,.581,11,28,.393,17,21,.810,122
51,PHI,2023-12-16,135,@,CHO,W 135-82,240,53,88,.602,39,57,.684,14,31,.452,15,17,.882,135,33,91,.363,26,56,.464,7,35,.200,9,11,.818,82
52,LAC,2023-12-16,144,,NYK,W 144-122,240,50,88,.568,34,55,.618,16,33,.485,28,34,.824,144,44,94,.468,33,59,.559,11,35,.314,23,26,.885,122
53,MIL,2023-12-16,146,,DET,W 146-114,240,50,88,.568,31,46,.674,19,42,.452,27,32,.844,146,43,96,.448,37,68,.544,6,28,.214,22,26,.846,114
54,NOP,2023-12-17,146,@,SAS,W 146-110,240,55,98,.561,33,56,.589,22,42,.524,14,22,.636,146,40,94,.426,25,52,.481,15,42,.357,15,21,.714,110
55,CLE,2023-12-18,135,,HOU,W 135-130 (OT),265,47,97,.485,28,49,.571,19,48,.396,22,34,.647,135,47,102,.461,35,69,.507,12,33,.364,24,27,.889,130
56,SAC,2023-12-18,143,,WAS,W 143-131,240,53,100,.530,36,57,.632,17,43,.395,20,26,.769,143,44,85,.518,26,47,.553,18,38,.474,25,30,.833,131
57,LAC,2023-12-18,151,@,IND,W 151-127,240,56,98,.571,37,60,.617,19,38,.500,20,23,.870,151,49,95,.516,37,62,.597,12,33,.364,17,21,.810,127
58,ATL,2023-12-20,134,@,HOU,W 134-127,240,47,91,.516,30,51,.588,17,40,.425,23,28,.821,134,44,89,.494,28,55,.509,16,34,.471,23,23,1.000,127
59,BOS,2023-12-20,144,@,SAC,W 144-119,240,51,92,.554,29,50,.580,22,42,.524,20,24,.833,144,43,91,.473,22,47,.468,21,44,.477,12,23,.522,119
60,IND,2023-12-20,144,,CHO,W 144-113,240,49,80,.613,31,41,.756,18,39,.462,28,30,.933,144,45,95,.474,37,64,.578,8,31,.258,15,19,.789,113
61,OKC,2023-12-21,134,,LAC,W 134-115,240,51,87,.586,35,53,.660,16,34,.471,16,18,.889,134,44,93,.473,27,50,.540,17,43,.395,10,12,.833,115
62,DAL,2023-12-23,144,,SAS,W 144-119,240,52,100,.520,29,55,.527,23,45,.511,17,21,.810,144,44,98,.449,30,53,.566,14,45,.311,17,24,.708,119
63,BOS,2023-12-23,145,@,LAC,W 145-108,240,49,94,.521,24,41,.585,25,53,.472,22,28,.786,145,41,89,.461,30,55,.545,11,34,.324,15,15,1.000,108
64,MIL,2023-12-27,144,@,BRK,W 144-122,240,52,89,.584,29,38,.763,23,51,.451,17,23,.739,144,45,101,.446,38,69,.551,7,32,.219,25,29,.862,122
65,LAL,2023-12-28,133,,CHO,W 133-112,240,52,97,.536,37,67,.552,15,30,.500,14,14,1.000,133,40,85,.471,25,52,.481,15,33,.455,17,28,.607,112
66,DEN,2023-12-28,142,,MEM,W 142-105,240,55,96,.573,35,55,.636,20,41,.488,12,14,.857,142,37,89,.416,24,54,.444,13,35,.371,18,25,.720,105
67,PHO,2023-12-29,133,,CHO,W 133-119,240,46,74,.622,28,44,.636,18,30,.600,23,24,.958,133,44,92,.478,21,46,.457,23,46,.500,8,8,1.000,119
68,POR,2023-12-29,134,,SAS,W 134-128,240,48,95,.505,32,68,.471,16,27,.593,22,27,.815,134,48,94,.511,34,61,.557,14,33,.424,18,25,.720,128
69,IND,2023-12-30,140,,NYK,W 140-126,240,50,85,.588,27,42,.643,23,43,.535,17,21,.810,140,45,95,.474,28,58,.483,17,37,.459,19,27,.704,126
70,BOS,2023-12-31,134,@,SAS,W 134-101,240,51,95,.537,36,53,.679,15,42,.357,17,22,.773,134,40,94,.426,28,49,.571,12,45,.267,9,12,.750,101
71,HOU,2024-01-01,136,,DET,W 136-113,240,51,91,.560,36,56,.643,15,35,.429,19,24,.792,136,40,83,.482,27,54,.500,13,29,.448,20,27,.741,113
72,ORL,2024-01-03,135,@,SAC,L 135-138 (2OT),290,44,90,.489,19,46,.413,25,44,.568,22,27,.815,135,51,105,.486,36,65,.554,15,40,.375,21,31,.677,138
73,SAC,2024-01-03,138,,ORL,W 138-135 (2OT),290,51,105,.486,36,65,.554,15,40,.375,21,31,.677,138,44,90,.489,19,46,.413,25,44,.568,22,27,.815,135
74,OKC,2024-01-03,138,@,ATL,L 138-141,240,50,91,.549,32,55,.582,18,36,.500,20,26,.769,138,48,95,.505,34,56,.607,14,39,.359,31,33,.939,141
75,CLE,2024-01-03,140,,WAS,W 140-101,240,54,101,.535,34,59,.576,20,42,.476,12,16,.750,140,42,101,.416,30,66,.455,12,35,.343,5,11,.455,101
76,ATL,2024-01-03,141,,OKC,W 141-138,240,48,95,.505,34,56,.607,14,39,.359,31,33,.939,141,50,91,.549,32,55,.582,18,36,.500,20,26,.769,138
77,IND,2024-01-03,142,,MIL,W 142-130,240,50,90,.556,36,55,.655,14,35,.400,28,34,.824,142,46,92,.500,32,55,.582,14,37,.378,24,32,.750,130
78,DET,2024-01-03,148,@,UTA,L 148-154 (OT),265,56,105,.533,37,64,.578,19,41,.463,17,22,.773,148,53,103,.515,37,71,.521,16,32,.500,32,35,.914,154
79,UTA,2024-01-03,154,,DET,W 154-148 (OT),265,53,103,.515,37,71,.521,16,32,.500,32,35,.914,154,56,105,.533,37,64,.578,19,41,.463,17,22,.773,148
80,SAC,2024-01-05,135,,TOR,W 135-130,240,52,100,.520,31,62,.500,21,38,.553,10,15,.667,135,47,87,.540,34,50,.680,13,37,.351,23,27,.852,130
81,DAL,2024-01-05,139,,POR,W 139-103,240,56,96,.583,39,58,.672,17,38,.447,10,15,.667,139,39,95,.411,26,55,.473,13,40,.325,12,17,.706,103
82,IND,2024-01-05,150,,ATL,W 150-116,240,60,94,.638,41,55,.745,19,39,.487,11,13,.846,150,40,93,.430,30,51,.588,10,42,.238,26,30,.867,116
83,TOR,2024-01-07,133,@,GSW,W 133-118,240,55,94,.585,40,61,.656,15,33,.455,8,14,.571,133,45,100,.450,31,54,.574,14,46,.304,14,15,.933,118
84,NOP,2024-01-07,133,@,SAC,W 133-100,240,50,82,.610,31,47,.660,19,35,.543,14,16,.875,133,38,91,.418,23,46,.500,15,45,.333,9,12,.750,100
85,POR,2024-01-07,134,@,BRK,W 134-127 (OT),265,45,95,.474,25,57,.439,20,38,.526,24,30,.800,134,46,91,.505,32,54,.593,14,37,.378,21,25,.840,127
86,IND,2024-01-08,133,,BOS,W 133-131,240,48,91,.527,29,51,.569,19,40,.475,18,22,.818,133,47,90,.522,30,55,.545,17,35,.486,20,29,.690,131
87,OKC,2024-01-08,136,@,WAS,W 136-128,240,52,88,.591,38,60,.633,14,28,.500,18,24,.750,136,44,89,.494,29,57,.509,15,32,.469,25,29,.862,128
88,LAC,2024-01-08,138,,PHO,W 138-111,240,53,85,.624,38,56,.679,15,29,.517,17,23,.739,138,38,77,.494,28,47,.596,10,30,.333,25,29,.862,111
89,LAL,2024-01-09,132,,TOR,W 132-131,240,44,81,.543,28,45,.622,16,36,.444,28,36,.778,132,53,94,.564,36,59,.610,17,35,.486,8,13,.615,131
90,PHI,2024-01-10,132,@,ATL,L 132-139 (OT),265,46,102,.451,34,68,.500,12,34,.353,28,33,.848,132,48,102,.471,36,68,.529,12,34,.353,31,42,.738,139
91,ATL,2024-01-10,139,,PHI,W 139-132 (OT),265,48,102,.471,36,68,.529,12,34,.353,31,42,.738,139,46,102,.451,34,68,.500,12,34,.353,28,33,.848,132
92,NOP,2024-01-10,141,@,GSW,W 141-105,240,54,94,.574,35,54,.648,19,40,.475,14,19,.737,141,39,89,.438,27,50,.540,12,39,.308,15,18,.833,105
93,MIL,2024-01-11,135,,BOS,W 135-102,240,52,92,.565,34,50,.680,18,42,.429,13,16,.813,135,34,91,.374,25,56,.446,9,35,.257,25,30,.833,102
94,OKC,2024-01-11,139,,POR,W 139-77,240,53,93,.570,39,58,.672,14,35,.400,19,22,.864,139,28,101,.277,17,52,.327,11,49,.224,10,16,.625,77
95,SAS,2024-01-12,135,,CHO,W 135-99,240,45,87,.517,27,49,.551,18,38,.474,27,34,.794,135,32,89,.360,22,55,.400,10,34,.294,25,28,.893,99
96,GSW,2024-01-12,140,@,CHI,W 140-131,240,49,94,.521,29,47,.617,20,47,.426,22,30,.733,140,50,86,.581,32,46,.696,18,40,.450,13,16,.813,131
97,UTA,2024-01-12,145,,TOR,W 145-113,240,52,93,.559,31,50,.620,21,43,.488,20,26,.769,145,35,81,.432,18,47,.383,17,34,.500,26,37,.703,113
98,UTA,2024-01-13,132,,LAL,W 132-125,240,42,93,.452,30,56,.536,12,37,.324,36,39,.923,132,46,92,.500,33,63,.524,13,29,.448,20,24,.833,125
99,BOS,2024-01-13,145,,HOU,W 145-113,240,51,95,.537,27,48,.563,24,47,.511,19,25,.760,145,40,99,.404,33,69,.478,7,30,.233,26,30,.867,113
100,SAC,2024-01-14,142,@,MIL,L 142-143 (OT),265,55,105,.524,38,64,.594,17,41,.415,15,20,.750,142,48,92,.522,28,49,.571,20,43,.465,27,32,.844,143
101,MIL,2024-01-14,143,,SAC,W 143-142 (OT),265,48,92,.522,28,49,.571,20,43,.465,27,32,.844,143,55,105,.524,38,64,.594,17,41,.415,15,20,.750,142
102,UTA,2024-01-15,132,,IND,W 132-105,240,45,81,.556,34,56,.607,11,25,.440,31,35,.886,132,38,95,.400,29,64,.453,9,31,.290,20,25,.800,105
103,NOP,2024-01-17,132,,CHO,W 132-112,240,44,88,.500,19,41,.463,25,47,.532,19,23,.826,132,39,90,.433,20,45,.444,19,45,.422,15,18,.833,112
104,CLE,2024-01-17,135,,MIL,W 135-95,240,55,93,.591,43,65,.662,12,28,.429,13,19,.684,135,38,95,.400,26,53,.491,12,42,.286,7,10,.700,95
105,OKC,2024-01-18,134,@,UTA,W 134-129,240,48,86,.558,34,54,.630,14,32,.438,24,28,.857,134,43,89,.483,30,57,.526,13,32,.406,30,36,.833,129
106,DET,2024-01-20,135,,MIL,L 135-141,240,44,94,.468,23,57,.404,21,37,.568,26,32,.813,135,47,85,.553,35,53,.660,12,32,.375,35,49,.714,141
107,MIL,2024-01-20,141,@,DET,W 141-135,240,47,85,.553,35,53,.660,12,32,.375,35,49,.714,141,44,94,.468,23,57,.404,21,37,.568,26,32,.813,135
108,LAL,2024-01-21,134,,POR,W 134-110,240,47,86,.547,34,53,.642,13,33,.394,27,29,.931,134,42,90,.467,33,61,.541,9,29,.310,17,20,.850,110
109,PHI,2024-01-22,133,,SAS,W 133-123,240,48,97,.495,43,77,.558,5,20,.250,32,40,.800,133,43,93,.462,30,52,.577,13,41,.317,24,27,.889,123
110,NOP,2024-01-23,153,,UTA,W 153-124,240,60,104,.577,37,58,.638,23,46,.500,10,15,.667,153,43,92,.467,31,56,.554,12,36,.333,26,32,.813,124
111,PHO,2024-01-24,132,@,DAL,W 132-109,240,51,85,.600,37,51,.725,14,34,.412,16,22,.727,132,41,89,.461,24,46,.522,17,43,.395,10,18,.556,109
112,GSW,2024-01-24,134,,ATL,W 134-112,240,51,91,.560,35,58,.603,16,33,.485,16,22,.727,134,39,94,.415,25,51,.490,14,43,.326,20,26,.769,112
113,POR,2024-01-24,137,@,HOU,W 137-131 (OT),265,50,98,.510,35,63,.556,15,35,.429,22,24,.917,137,50,94,.532,38,58,.655,12,36,.333,19,22,.864,131
114,OKC,2024-01-24,140,@,SAS,W 140-114,240,54,96,.563,36,56,.643,18,40,.450,14,16,.875,140,43,86,.500,34,54,.630,9,32,.281,19,25,.760,114
115,CHI,2024-01-25,132,@,LAL,L 132-141,240,47,88,.534,35,51,.686,12,37,.324,26,29,.897,132,53,87,.609,33,56,.589,20,31,.645,15,20,.750,141
116,GSW,2024-01-25,133,,SAC,L 133-134,240,48,86,.558,29,49,.592,19,37,.514,18,23,.783,133,48,91,.527,26,43,.605,22,48,.458,16,19,.842,134
117,SAC,2024-01-25,134,@,GSW,W 134-133,240,48,91,.527,26,43,.605,22,48,.458,16,19,.842,134,48,86,.558,29,49,.592,19,37,.514,18,23,.783,133
118,IND,2024-01-25,134,,PHI,W 134-122,240,53,93,.570,41,65,.631,12,28,.429,16,21,.762,134,42,87,.483,35,58,.603,7,29,.241,31,43,.721,122
119,LAL,2024-01-25,141,,CHI,W 141-132,240,53,87,.609,33,56,.589,20,31,.645,15,20,.750,141,47,88,.534,35,51,.686,12,37,.324,26,29,.897,132
120,BOS,2024-01-25,143,@,MIA,W 143-110,240,51,80,.638,29,40,.725,22,40,.550,19,20,.950,143,42,94,.447,26,52,.500,16,42,.381,10,13,.769,110
121,IND,2024-01-26,133,,PHO,W 133-131,240,58,109,.532,50,83,.602,8,26,.308,9,15,.600,133,51,89,.573,38,59,.644,13,30,.433,16,18,.889,131
122,HOU,2024-01-26,138,@,CHO,W 138-104,240,50,89,.562,37,56,.661,13,33,.394,25,31,.806,138,35,85,.412,26,56,.464,9,29,.310,25,32,.781,104
123,ATL,2024-01-26,143,,DAL,L 143-148,240,51,97,.526,36,63,.571,15,34,.441,26,30,.867,143,51,85,.600,32,50,.640,19,35,.543,27,32,.844,148
124,DAL,2024-01-26,148,@,ATL,W 148-143,240,51,85,.600,32,50,.640,19,35,.543,27,32,.844,148,51,97,.526,36,63,.571,15,34,.441,26,30,.867,143
125,UTA,2024-01-27,134,@,CHO,W 134-122,240,52,93,.559,35,52,.673,17,41,.415,13,17,.765,134,47,92,.511,34,60,.567,13,32,.406,15,21,.714,122
126,MIL,2024-01-27,141,,NOP,W 141-117,240,51,91,.560,31,46,.674,20,45,.444,19,25,.760,141,40,85,.471,31,62,.500,9,23,.391,28,36,.778,117
127,GSW,2024-01-27,144,,LAL,L 144-145 (2OT),290,55,119,.462,32,61,.525,23,58,.397,11,16,.688,144,49,101,.485,40,74,.541,9,27,.333,38,43,.884,145
128,LAL,2024-01-27,145,@,GSW,W 145-144 (2OT),290,49,101,.485,40,74,.541,9,27,.333,38,43,.884,145,55,119,.462,32,61,.525,23,58,.397,11,16,.688,144
129,HOU,2024-01-29,135,,LAL,W 135-119,240,52,98,.531,40,62,.645,12,36,.333,19,25,.760,135,45,91,.495,32,56,.571,13,35,.371,16,26,.615,119
130,BRK,2024-01-29,147,,UTA,W 147-114,240,54,105,.514,33,60,.550,21,45,.467,18,19,.947,147,39,86,.453,30,59,.508,9,27,.333,27,34,.794,114
131,ATL,2024-01-30,138,,LAL,W 138-122,240,53,101,.525,37,63,.587,16,38,.421,16,18,.889,138,48,90,.533,36,57,.632,12,33,.364,14,25,.560,122
132,PHO,2024-01-31,136,@,BRK,W 136-120,240,49,79,.620,35,51,.686,14,28,.500,24,32,.750,136,47,94,.500,31,55,.564,16,39,.410,10,13,.769,120
133,SAC,2024-02-02,133,@,IND,W 133-122,240,51,90,.567,38,56,.679,13,34,.382,18,28,.643,133,46,85,.541,36,56,.643,10,29,.345,20,24,.833,122
134,HOU,2024-02-02,135,,TOR,W 135-106,240,55,93,.591,44,62,.710,11,31,.355,14,17,.824,135,40,91,.440,29,58,.500,11,33,.333,15,20,.750,106
135,LAC,2024-02-02,136,@,DET,W 136-125,240,53,89,.596,39,60,.650,14,29,.483,16,19,.842,136,45,89,.506,28,49,.571,17,40,.425,18,24,.750,125
136,GSW,2024-02-03,134,@,ATL,L 134-141 (OT),265,50,112,.446,32,56,.571,18,56,.321,16,20,.800,134,55,114,.482,41,71,.577,14,43,.326,17,22,.773,141
137,BRK,2024-02-03,136,@,PHI,W 136-121,240,49,95,.516,29,44,.659,20,51,.392,18,23,.783,136,44,96,.458,32,67,.478,12,29,.414,21,27,.778,121
138,ATL,2024-02-03,141,,GSW,W 141-134 (OT),265,55,114,.482,41,71,.577,14,43,.326,17,22,.773,141,50,112,.446,32,56,.571,18,56,.321,16,20,.800,134
139,OKC,2024-02-04,135,,TOR,W 135-127 (2OT),290,52,110,.473,29,47,.617,23,63,.365,8,8,1.000,135,48,101,.475,34,66,.515,14,35,.400,17,21,.810,127
140,PHO,2024-02-04,140,@,WAS,W 140-112,240,54,88,.614,43,63,.683,11,25,.440,21,26,.808,140,47,96,.490,40,64,.625,7,32,.219,11,17,.647,112
141,CLE,2024-02-05,136,,SAC,W 136-110,240,51,88,.580,28,47,.596,23,41,.561,11,17,.647,136,43,93,.462,26,49,.531,17,44,.386,7,12,.583,110
142,NOP,2024-02-05,138,,TOR,W 138-100,240,53,104,.510,34,59,.576,19,45,.422,13,13,1.000,138,40,84,.476,30,53,.566,10,31,.323,10,15,.667,100
143,ATL,2024-02-05,144,,LAC,L 144-149,240,51,95,.537,31,56,.554,20,39,.513,22,27,.815,144,52,89,.584,31,54,.574,21,35,.600,24,31,.774,149
144,LAC,2024-02-05,149,@,ATL,W 149-144,240,52,89,.584,31,54,.574,21,35,.600,24,31,.774,149,51,95,.537,31,56,.554,20,39,.513,22,27,.815,144
145,IND,2024-02-06,132,,HOU,W 132-129,240,54,86,.628,39,54,.722,15,32,.469,9,14,.643,132,50,97,.515,38,72,.528,12,25,.480,17,23,.739,129
146,DET,2024-02-07,133,@,SAC,W 133-120,240,47,84,.560,30,53,.566,17,31,.548,22,22,1.000,133,45,95,.474,30,51,.588,15,44,.341,15,22,.682,120
147,BOS,2024-02-09,133,,WAS,W 133-129,240,48,92,.522,37,58,.638,11,34,.324,26,28,.929,133,45,95,.474,25,48,.521,20,47,.426,19,21,.905,129
148,SAC,2024-02-09,135,,DEN,W 135-106,240,51,87,.586,34,53,.642,17,34,.500,16,18,.889,135,38,82,.463,28,53,.528,10,29,.345,20,28,.714,106
149,LAL,2024-02-09,139,,NOP,W 139-122,240,49,88,.557,35,57,.614,14,31,.452,27,32,.844,139,46,89,.517,35,60,.583,11,29,.379,19,23,.826,122
150,DAL,2024-02-10,146,,OKC,W 146-111,240,53,91,.582,38,53,.717,15,38,.395,25,33,.758,146,38,98,.388,21,51,.412,17,47,.362,18,21,.857,111
151,CHI,2024-02-12,136,@,ATL,W 136-126,240,51,92,.554,38,64,.594,13,28,.464,21,29,.724,136,44,94,.468,30,51,.588,14,43,.326,24,29,.828,126
152,NOP,2024-02-14,133,,WAS,W 133-126,240,50,89,.562,40,57,.702,10,32,.313,23,29,.793,133,44,92,.478,23,47,.489,21,45,.467,17,20,.850,126
153,BOS,2024-02-14,136,,BRK,W 136-86,240,52,91,.571,30,46,.652,22,45,.489,10,12,.833,136,31,81,.383,21,50,.420,10,31,.323,14,15,.933,86
154,LAL,2024-02-14,138,@,UTA,W 138-122,240,52,91,.571,38,60,.633,14,31,.452,20,24,.833,138,49,101,.485,35,56,.625,14,45,.311,10,13,.769,122
155,UTA,2024-02-15,137,,GSW,L 137-140,240,43,93,.462,21,44,.477,22,49,.449,29,32,.906,137,49,92,.533,29,50,.580,20,42,.476,22,28,.786,140
156,GSW,2024-02-15,140,@,UTA,W 140-137,240,49,92,.533,29,50,.580,20,42,.476,22,28,.786,140,43,93,.462,21,44,.477,22,49,.449,29,32,.906,137
157,OKC,2024-02-23,147,,WAS,W 147-106,240,55,92,.598,35,52,.673,20,40,.500,17,21,.810,147,41,104,.394,32,66,.485,9,38,.237,15,21,.714,106
158,IND,2024-02-25,133,,DAL,W 133-111,240,52,93,.559,38,57,.667,14,36,.389,15,17,.882,133,41,87,.471,27,56,.482,14,31,.452,15,21,.714,111
159,CHI,2024-02-28,132,,CLE,W 132-123 (2OT),290,44,110,.400,31,73,.425,13,37,.351,31,38,.816,132,45,104,.433,23,50,.460,22,54,.407,11,19,.579,123
160,DAL,2024-02-28,136,@,TOR,W 136-125,240,52,96,.542,37,53,.698,15,43,.349,17,21,.810,136,46,98,.469,33,63,.524,13,35,.371,20,30,.667,125
161,SAS,2024-02-29,132,,OKC,W 132-118,240,48,91,.527,29,52,.558,19,39,.487,17,20,.850,132,44,89,.494,35,58,.603,9,31,.290,21,22,.955,118
162,LAL,2024-02-29,134,,WAS,W 134-131 (OT),265,53,101,.525,45,78,.577,8,23,.348,20,24,.833,134,52,102,.510,35,61,.574,17,41,.415,10,12,.833,131
163,BOS,2024-03-01,138,,DAL,W 138-110,240,52,94,.553,31,51,.608,21,43,.488,13,13,1.000,138,44,94,.468,35,60,.583,9,34,.265,13,18,.722,110
164,LAC,2024-03-01,140,,WAS,W 140-115,240,54,94,.574,41,62,.661,13,32,.406,19,25,.760,140,46,98,.469,34,64,.531,12,34,.353,11,15,.733,115
165,BOS,2024-03-03,140,,GSW,W 140-88,240,53,96,.552,28,47,.596,25,49,.510,9,11,.818,140,36,92,.391,29,51,.569,7,41,.171,9,13,.692,88
166,IND,2024-03-05,137,@,DAL,W 137-120,240,50,93,.538,32,54,.593,18,39,.462,19,24,.792,137,45,93,.484,32,54,.593,13,39,.333,17,21,.810,120
167,NOP,2024-03-05,139,@,TOR,W 139-98,240,53,105,.505,29,56,.518,24,49,.490,9,11,.818,139,36,93,.387,23,49,.469,13,44,.295,13,22,.591,98
168,DEN,2024-03-09,142,,UTA,W 142-121,240,55,83,.663,36,51,.706,19,32,.594,13,16,.813,142,47,94,.500,39,68,.574,8,26,.308,19,25,.760,121
169,DAL,2024-03-09,142,@,DET,W 142-124,240,51,92,.554,37,54,.685,14,38,.368,26,32,.813,142,45,99,.455,32,62,.516,13,37,.351,21,25,.840,124
170,CHI,2024-03-13,132,@,IND,W 132-129 (OT),265,48,92,.522,38,64,.594,10,28,.357,26,32,.813,132,46,99,.465,32,54,.593,14,45,.311,23,28,.821,129
171,HOU,2024-03-14,135,,WAS,W 135-119,240,51,87,.586,39,59,.661,12,28,.429,21,24,.875,135,46,93,.495,34,55,.618,12,38,.316,15,19,.789,119
172,MIL,2024-03-17,140,,PHO,W 140-129,240,51,94,.543,27,53,.509,24,41,.585,14,14,1.000,140,51,87,.586,37,54,.685,14,33,.424,13,15,.867,129
173,LAL,2024-03-18,136,,ATL,W 136-105,240,52,90,.578,37,54,.685,15,36,.417,17,20,.850,136,42,98,.429,33,57,.579,9,41,.220,12,15,.800,105
174,HOU,2024-03-19,137,@,WAS,W 137-114,240,47,91,.516,34,52,.654,13,39,.333,30,36,.833,137,42,98,.429,27,59,.458,15,39,.385,15,20,.750,114
175,GSW,2024-03-20,137,,MEM,W 137-116,240,58,100,.580,39,61,.639,19,39,.487,2,6,.333,137,42,96,.438,24,47,.511,18,49,.367,14,18,.778,116
176,ATL,2024-03-23,132,,CHO,W 132-91,240,50,90,.556,30,48,.625,20,42,.476,12,14,.857,132,35,84,.417,24,45,.533,11,39,.282,10,14,.714,91
177,HOU,2024-03-23,147,,UTA,W 147-119,240,54,97,.557,27,48,.563,27,49,.551,12,14,.857,147,40,89,.449,29,52,.558,11,37,.297,28,33,.848,119
178,IND,2024-03-24,145,@,LAL,L 145-150,240,59,107,.551,41,71,.577,18,36,.500,9,16,.563,145,50,89,.562,38,64,.594,12,25,.480,38,43,.884,150
179,LAL,2024-03-24,150,,IND,W 150-145,240,50,89,.562,38,64,.594,12,25,.480,38,43,.884,150,59,107,.551,41,71,.577,18,36,.500,9,16,.563,145
180,IND,2024-03-25,133,@,LAC,W 133-116,240,50,86,.581,33,58,.569,17,28,.607,16,22,.727,133,46,85,.541,40,65,.615,6,20,.300,18,22,.818,116
181,DAL,2024-03-26,132,@,SAC,W 132-96,240,51,92,.554,29,53,.547,22,39,.564,8,13,.615,132,35,90,.389,24,60,.400,11,30,.367,15,19,.789,96
182,HOU,2024-03-27,132,@,OKC,W 132-126 (OT),265,50,104,.481,35,61,.574,15,43,.349,17,23,.739,132,47,96,.490,33,58,.569,14,38,.368,18,24,.750,126
183,LAL,2024-03-27,136,@,MEM,W 136-124,240,45,81,.556,27,48,.563,18,33,.545,28,35,.800,136,46,97,.474,29,54,.537,17,43,.395,15,19,.789,124
184,NYK,2024-03-27,145,@,TOR,W 145-101,240,55,94,.585,33,50,.660,22,44,.500,13,16,.813,145,39,84,.464,28,53,.528,11,31,.355,12,13,.923,101
185,MIA,2024-03-29,142,,POR,W 142-82,240,54,92,.587,33,53,.623,21,39,.538,13,18,.722,142,35,87,.402,30,57,.526,5,30,.167,7,11,.636,82
186,PHI,2024-03-31,135,@,TOR,W 135-120,240,49,83,.590,25,40,.625,24,43,.558,13,16,.813,135,47,90,.522,36,60,.600,11,30,.367,15,20,.750,120
187,IND,2024-04-01,133,,BRK,W 133-111,240,53,103,.515,40,72,.556,13,31,.419,14,17,.824,133,41,87,.471,31,61,.508,10,26,.385,19,28,.679,111
188,MIN,2024-04-03,133,,TOR,W 133-85,240,49,96,.510,29,53,.547,20,43,.465,15,22,.682,133,33,90,.367,26,60,.433,7,30,.233,12,14,.857,85
189,BOS,2024-04-03,135,,OKC,W 135-100,240,50,92,.543,33,52,.635,17,40,.425,18,19,.947,135,35,81,.432,30,57,.526,5,24,.208,25,28,.893,100
190,GSW,2024-04-04,133,@,HOU,W 133-110,240,47,80,.588,30,45,.667,17,35,.486,22,25,.880,133,36,86,.419,24,46,.522,12,40,.300,26,30,.867,110
191,DEN,2024-04-06,142,,ATL,W 142-110,240,53,88,.602,30,47,.638,23,41,.561,13,16,.813,142,37,87,.425,25,50,.500,12,37,.324,24,29,.828,110
192,PHI,2024-04-07,133,@,SAS,W 133-126 (2OT),290,52,114,.456,40,75,.533,12,39,.308,17,19,.895,133,44,98,.449,28,54,.519,16,44,.364,22,26,.846,126
193,HOU,2024-04-07,136,@,DAL,L 136-147 (OT),265,46,93,.495,29,52,.558,17,41,.415,27,35,.771,136,46,85,.541,31,46,.674,15,39,.385,40,45,.889,147
194,DAL,2024-04-07,147,,HOU,W 147-136 (OT),265,46,85,.541,31,46,.674,15,39,.385,40,45,.889,147,46,93,.495,29,52,.558,17,41,.415,27,35,.771,136
195,GSW,2024-04-09,134,@,LAL,W 134-120,240,47,80,.588,21,39,.538,26,41,.634,14,21,.667,134,44,96,.458,32,61,.525,12,35,.343,20,24,.833,120
196,IND,2024-04-09,140,@,TOR,W 140-123,240,54,99,.545,38,54,.704,16,45,.356,16,23,.696,140,47,94,.500,42,73,.575,5,21,.238,24,33,.727,123
197,NOP,2024-04-11,135,@,SAC,W 135-123,240,49,86,.570,27,46,.587,22,40,.550,15,18,.833,135,46,84,.548,30,46,.652,16,38,.421,15,20,.750,123
198,BOS,2024-04-14,132,,WAS,W 132-122,240,51,89,.573,35,57,.614,16,32,.500,14,21,.667,132,49,103,.476,35,65,.538,14,38,.368,10,10,1.000,122
199,OKC,2024-04-14,135,,DAL,W 135-86,240,54,97,.557,40,63,.635,14,34,.412,13,16,.813,135,32,97,.330,24,58,.414,8,39,.205,14,17,.824,86
200,IND,2024-04-14,157,,ATL,W 157-115,240,65,100,.650,46,64,.719,19,36,.528,8,10,.800,157,39,89,.438,27,53,.509,12,36,.333,25,27,.926,115
201,UTA,2024-01-08,132,@,MIL,W 132-116,240,47,90,.522,27,46,.587,20,44,.455,18,22,.818,132,42,94,.447,25,58,.431,17,36,.472,15,19,.789,116
202,DAL,2023-12-30,132,@,GSW,W 132-122,240,49,88,.557,33,48,.688,16,40,.400,18,22,.818,132,47,103,.456,28,55,.509,19,48,.396,9,13,.692,122
203,TOR,2023-12-27,132,@,WAS,W 132-102,240,52,91,.571,37,53,.698,15,38,.395,13,19,.684,132,42,90,.467,34,57,.596,8,33,.242,10,15,.667,102
204,GSW,2023-12-19,132,,BOS,W 132-126 (OT),265,50,109,.459,30,59,.508,20,50,.400,12,14,.857,132,47,114,.412,30,56,.536,17,58,.293,15,17,.882,126
205,MIL,2023-12-19,132,,SAS,W 132-119,240,50,106,.472,32,57,.561,18,49,.367,14,18,.778,132,46,96,.479,37,66,.561,9,30,.300,18,21,.857,119
206,LAC,2023-12-11,132,,POR,W 132-127,240,49,89,.551,36,55,.655,13,34,.382,21,22,.955,132,43,90,.478,24,50,.480,19,40,.475,22,26,.846,127
207,MIL,2023-12-02,132,,ATL,W 132-121,240,53,89,.596,39,56,.696,14,33,.424,12,15,.800,132,45,101,.446,30,63,.476,15,38,.395,16,21,.762,121
208,IND,2023-11-30,132,@,MIA,L 132-142,240,50,98,.510,39,55,.709,11,43,.256,21,32,.656,132,48,86,.558,40,65,.615,8,21,.381,38,45,.844,142
209,DEN,2023-11-26,132,,SAS,W 132-120,240,50,89,.562,38,61,.623,12,28,.429,20,25,.800,132,42,93,.452,28,56,.500,14,37,.378,22,26,.846,120
210,TOR,2023-11-22,132,@,IND,W 132-131,240,48,90,.533,37,63,.587,11,27,.407,25,30,.833,132,50,91,.549,32,52,.615,18,39,.462,13,16,.813,131
211,MIL,2023-11-18,132,,DAL,W 132-125,240,49,94,.521,32,49,.653,17,45,.378,17,20,.850,132,51,103,.495,35,56,.625,16,47,.340,7,10,.700,125
212,IND,2023-11-14,132,@,PHI,W 132-126,240,48,93,.516,35,56,.625,13,37,.351,23,33,.697,132,43,86,.500,37,64,.578,6,22,.273,34,35,.971,126
213,SAC,2023-11-13,132,,CLE,W 132-120,240,49,83,.590,29,41,.707,20,42,.476,14,22,.636,132,45,91,.495,29,56,.518,16,35,.457,14,17,.824,120
214,WAS,2023-11-08,132,@,CHO,W 132-116,240,47,97,.485,29,54,.537,18,43,.419,20,25,.800,132,41,79,.519,33,54,.611,8,25,.320,26,35,.743,116
215,SAS,2023-11-02,132,@,PHO,W 132-121,240,51,98,.520,33,61,.541,18,37,.486,12,13,.923,132,43,80,.538,27,48,.563,16,32,.500,19,26,.731,121
216,SAC,2023-10-29,132,,LAL,W 132-127 (OT),265,49,104,.471,32,56,.571,17,48,.354,17,24,.708,132,43,98,.439,28,53,.528,15,45,.333,26,34,.765,127
217,BOS,2024-04-12,131,,CHO,W 131-98,240,54,104,.519,40,63,.635,14,41,.341,9,13,.692,131,32,76,.421,17,41,.415,15,35,.429,19,22,.864,98
218,LAC,2024-04-05,131,,UTA,W 131-102,240,51,91,.560,38,56,.679,13,35,.371,16,18,.889,131,35,91,.385,26,61,.426,9,30,.300,23,29,.793,102
219,PHO,2024-03-23,131,@,SAS,W 131-106,240,56,94,.596,45,70,.643,11,24,.458,8,10,.800,131,40,85,.471,31,52,.596,9,33,.273,17,21,.810,106
220,SAC,2024-03-07,131,,SAS,W 131-129,240,52,102,.510,42,70,.600,10,32,.313,17,18,.944,131,46,91,.505,30,58,.517,16,33,.485,21,21,1.000,129
221,WAS,2024-02-29,131,@,LAL,L 131-134 (OT),265,52,102,.510,35,61,.574,17,41,.415,10,12,.833,131,53,101,.525,45,78,.577,8,23,.348,20,24,.833,134
222,GSW,2024-02-08,131,@,IND,W 131-109,240,52,93,.559,35,61,.574,17,32,.531,10,13,.769,131,39,81,.481,27,50,.540,12,31,.387,19,27,.704,109
223,BOS,2024-02-04,131,,MEM,W 131-91,240,48,99,.485,29,48,.604,19,51,.373,16,18,.889,131,35,92,.380,24,54,.444,11,38,.289,10,12,.833,91
224,DAL,2024-01-29,131,,ORL,W 131-129,240,43,69,.623,30,42,.714,13,27,.481,32,43,.744,131,45,88,.511,27,50,.540,18,38,.474,21,28,.750,129
225,PHO,2024-01-26,131,@,IND,L 131-133,240,51,89,.573,38,59,.644,13,30,.433,16,18,.889,131,58,109,.532,50,83,.602,8,26,.308,9,15,.600,133
226,HOU,2024-01-24,131,,POR,L 131-137 (OT),265,50,94,.532,38,58,.655,12,36,.333,19,22,.864,131,50,98,.510,35,63,.556,15,35,.429,22,24,.917,137
227,SAS,2024-01-20,131,@,WAS,W 131-127,240,51,96,.531,39,65,.600,12,31,.387,17,23,.739,131,49,103,.476,40,74,.541,9,29,.310,20,23,.870,127
228,CHI,2024-01-12,131,,GSW,L 131-140,240,50,86,.581,32,46,.696,18,40,.450,13,16,.813,131,49,94,.521,29,47,.617,20,47,.426,22,30,.733,140
229,SAC,2024-01-09,131,@,DET,W 131-110,240,54,94,.574,41,61,.672,13,33,.394,10,14,.714,131,40,85,.471,26,48,.542,14,37,.378,16,21,.762,110
230,TOR,2024-01-09,131,@,LAL,L 131-132,240,53,94,.564,36,59,.610,17,35,.486,8,13,.615,131,44,81,.543,28,45,.622,16,36,.444,28,36,.778,132
231,BOS,2024-01-08,131,@,IND,L 131-133,240,47,90,.522,30,55,.545,17,35,.486,20,29,.690,131,48,91,.527,29,51,.569,19,40,.475,18,22,.818,133
232,DEN,2024-01-07,131,,DET,W 131-114,240,47,80,.588,37,53,.698,10,27,.370,27,31,.871,131,42,89,.472,33,65,.508,9,24,.375,21,30,.700,114
233,LAC,2024-01-03,131,@,PHO,W 131-122,240,42,76,.553,24,42,.571,18,34,.529,29,32,.906,131,42,79,.532,27,44,.614,15,35,.429,23,26,.885,122
234,PHI,2023-12-29,131,@,HOU,W 131-127,240,45,86,.523,33,53,.623,12,33,.364,29,33,.879,131,49,91,.538,35,61,.574,14,30,.467,15,21,.714,127
235,WAS,2023-12-18,131,@,SAC,L 131-143,240,44,85,.518,26,47,.553,18,38,.474,25,30,.833,131,53,100,.530,36,57,.632,17,43,.395,20,26,.769,143
236,DAL,2023-12-16,131,@,POR,W 131-120,240,48,97,.495,32,50,.640,16,47,.340,19,21,.905,131,47,94,.500,40,62,.645,7,32,.219,19,22,.864,120
237,IND,2023-12-11,131,@,DET,W 131-123,240,52,92,.565,39,61,.639,13,31,.419,14,19,.737,131,45,81,.556,35,52,.673,10,29,.345,23,30,.767,123
238,SAC,2023-12-11,131,,BRK,W 131-118,240,48,94,.511,23,49,.469,25,45,.556,10,14,.714,131,42,88,.477,28,59,.475,14,29,.483,20,21,.952,118
239,PHI,2023-12-06,131,@,WAS,W 131-126,240,47,92,.511,39,65,.600,8,27,.296,29,34,.853,131,52,92,.565,38,57,.667,14,35,.400,8,8,1.000,126
240,LAC,2023-11-29,131,@,SAC,W 131-117,240,50,93,.538,36,65,.554,14,28,.500,17,22,.773,131,40,86,.465,27,45,.600,13,41,.317,24,28,.857,117
241,MIL,2023-11-28,131,@,MIA,W 131-124,240,47,88,.534,34,53,.642,13,35,.371,24,27,.889,131,48,94,.511,34,64,.531,14,30,.467,14,21,.667,124
242,MIL,2023-11-24,131,,WAS,W 131-128,240,48,92,.522,39,61,.639,9,31,.290,26,33,.788,131,48,100,.480,33,63,.524,15,37,.405,17,21,.810,128
243,IND,2023-11-22,131,,TOR,L 131-132,240,50,91,.549,32,52,.615,18,39,.462,13,16,.813,131,48,90,.533,37,63,.587,11,27,.407,25,30,.833,132
244,LAL,2023-11-21,131,,UTA,W 131-99,240,49,86,.570,38,57,.667,11,29,.379,22,27,.815,131,38,98,.388,27,54,.500,11,44,.250,12,16,.750,99
245,PHO,2023-11-17,131,@,UTA,W 131-128,240,45,86,.523,27,53,.509,18,33,.545,23,26,.885,131,43,85,.506,27,49,.551,16,36,.444,26,31,.839,128
246,NOP,2023-11-14,131,,DAL,W 131-110,240,49,94,.521,35,56,.625,14,38,.368,19,26,.731,131,38,90,.422,24,48,.500,14,42,.333,20,26,.769,110
247,DAL,2024-04-09,130,@,CHO,W 130-104,240,50,93,.538,33,43,.767,17,50,.340,13,20,.650,130,39,89,.438,29,57,.509,10,32,.313,16,21,.762,104
248,MIN,2024-04-09,130,,WAS,W 130-121,240,43,90,.478,25,49,.510,18,41,.439,26,32,.813,130,44,89,.494,24,46,.522,20,43,.465,13,17,.765,121
249,TOR,2024-04-07,130,,WAS,W 130-122,240,49,96,.510,38,65,.585,11,31,.355,21,28,.750,130,42,89,.472,26,49,.531,16,40,.400,22,30,.733,122
250,DEN,2024-03-31,130,,CLE,W 130-101,240,50,87,.575,29,54,.537,21,33,.636,9,13,.692,130,38,82,.463,30,57,.526,8,25,.320,17,21,.810,101
251,LAC,2024-03-31,130,@,CHO,W 130-118,240,43,75,.573,29,46,.630,14,29,.483,30,34,.882,130,44,88,.500,21,36,.583,23,52,.442,7,11,.636,118
252,SAS,2024-03-29,130,,NYK,W 130-126 (OT),265,44,82,.537,28,42,.667,16,40,.400,26,32,.813,130,51,110,.464,37,73,.507,14,37,.378,10,12,.833,126
253,BOS,2024-03-17,130,@,WAS,W 130-104,240,43,87,.494,19,37,.514,24,50,.480,20,24,.833,130,41,89,.461,31,55,.564,10,34,.294,12,14,.857,104
254,SAC,2024-03-06,130,@,LAL,W 130-120,240,54,97,.557,42,66,.636,12,31,.387,10,12,.833,130,42,81,.519,27,49,.551,15,32,.469,21,25,.840,120
255,TOR,2024-02-26,130,@,IND,W 130-122,240,53,96,.552,41,68,.603,12,28,.429,12,17,.706,130,46,100,.460,33,58,.569,13,42,.310,17,23,.739,122
256,DEN,2024-02-22,130,,WAS,W 130-110,240,56,101,.554,49,70,.700,7,31,.226,11,15,.733,130,40,104,.385,23,66,.348,17,38,.447,13,23,.565,110
257,LAC,2024-02-14,130,@,GSW,W 130-125,240,44,88,.500,31,50,.620,13,38,.342,29,37,.784,130,47,103,.456,29,56,.518,18,47,.383,13,18,.722,125
258,PHO,2024-02-13,130,,SAC,W 130-125,240,44,85,.518,31,54,.574,13,31,.419,29,36,.806,130,49,95,.516,40,64,.625,9,31,.290,18,24,.750,125
259,POR,2024-01-29,130,,PHI,W 130-104,240,46,84,.548,34,56,.607,12,28,.429,26,29,.897,130,37,83,.446,32,54,.593,5,29,.172,25,28,.893,104
260,BRK,2024-01-19,130,@,LAL,W 130-112,240,50,95,.526,31,48,.646,19,47,.404,11,14,.786,130,40,90,.444,28,57,.491,12,33,.364,20,24,.833,112
261,SAS,2024-01-10,130,@,DET,W 130-108,240,49,94,.521,40,67,.597,9,27,.333,23,27,.852,130,44,96,.458,34,64,.531,10,32,.313,10,13,.769,108
262,TOR,2024-01-05,130,@,SAC,L 130-135,240,47,87,.540,34,50,.680,13,37,.351,23,27,.852,130,52,100,.520,31,62,.500,21,38,.553,10,15,.667,135
263,DEN,2024-01-04,130,@,GSW,W 130-127,240,48,85,.565,39,59,.661,9,26,.346,25,29,.862,130,49,90,.544,34,54,.630,15,36,.417,14,16,.875,127
264,MIL,2024-01-03,130,@,IND,L 130-142,240,46,92,.500,32,55,.582,14,37,.378,24,32,.750,130,50,90,.556,36,55,.655,14,35,.400,28,34,.824,142
265,ATL,2023-12-31,130,@,WAS,W 130-126,240,47,95,.495,35,63,.556,12,32,.375,24,37,.649,130,46,98,.469,29,45,.644,17,53,.321,17,21,.810,126
266,UTA,2023-12-26,130,@,SAS,W 130-118,240,47,95,.495,31,52,.596,16,43,.372,20,22,.909,130,44,98,.449,28,63,.444,16,35,.457,14,21,.667,118
267,POR,2023-12-26,130,,SAC,W 130-113,240,49,98,.500,33,58,.569,16,40,.400,16,20,.800,130,45,93,.484,35,51,.686,10,42,.238,13,16,.813,113
268,MIL,2023-12-23,130,@,NYK,W 130-111,240,48,91,.527,32,59,.542,16,32,.500,18,23,.783,130,41,93,.441,32,64,.500,9,29,.310,20,21,.952,111
269,ATL,2023-12-18,130,,DET,W 130-124,240,46,85,.541,30,49,.612,16,36,.444,22,27,.815,130,48,94,.511,39,72,.542,9,22,.409,19,27,.704,124
270,DEN,2023-12-18,130,,DAL,W 130-104,240,49,87,.563,35,61,.574,14,26,.538,18,22,.818,130,41,92,.446,28,54,.519,13,38,.342,9,19,.474,104
271,HOU,2023-12-18,130,@,CLE,L 130-135 (OT),265,47,102,.461,35,69,.507,12,33,.364,24,27,.889,130,47,97,.485,28,49,.571,19,48,.396,22,34,.647,135
272,TOR,2023-12-11,130,@,NYK,L 130-136,240,47,96,.490,33,57,.579,14,39,.359,22,30,.733,130,52,86,.605,35,57,.614,17,29,.586,15,23,.652,136
273,ORL,2023-12-01,130,,WAS,W 130-125,240,46,89,.517,34,58,.586,12,31,.387,26,33,.788,130,45,89,.506,32,61,.525,13,28,.464,22,31,.710,125
274,ORL,2023-11-26,130,,CHO,W 130-117,240,47,87,.540,37,60,.617,10,27,.370,26,33,.788,130,44,83,.530,31,53,.585,13,30,.433,16,25,.640,117
275,OKC,2023-11-18,130,@,GSW,W 130-123 (OT),265,52,100,.520,44,77,.571,8,23,.348,18,20,.900,130,44,97,.454,26,51,.510,18,46,.391,17,21,.810,123
276,MIL,2023-11-17,130,@,CHO,W 130-99,240,49,89,.551,27,44,.614,22,45,.489,10,13,.769,130,37,91,.407,31,65,.477,6,26,.231,19,22,.864,99
277,DAL,2023-11-15,130,@,WAS,W 130-117,240,48,92,.522,31,50,.620,17,42,.405,17,29,.586,130,43,89,.483,31,53,.585,12,36,.333,19,23,.826,117
278,CHI,2023-11-06,130,,UTA,W 130-113,240,48,93,.516,30,59,.508,18,34,.529,16,19,.842,130,41,86,.477,25,43,.581,16,43,.372,15,17,.882,113
279,ATL,2023-11-01,130,,WAS,W 130-121,240,46,92,.500,37,60,.617,9,32,.281,29,32,.906,130,51,101,.505,41,61,.672,10,40,.250,9,14,.643,121
280,LAL,2023-11-01,130,,LAC,W 130-125 (OT),265,46,90,.511,35,58,.603,11,32,.344,27,36,.750,130,47,99,.475,33,65,.508,14,34,.412,17,27,.630,125
281,TOR,2023-11-01,130,,MIL,W 130-111,240,51,91,.560,36,53,.679,15,38,.395,13,14,.929,130,35,76,.461,22,42,.524,13,34,.382,28,38,.737,111
282,GSW,2023-10-30,130,@,NOP,W 130-102,240,51,98,.520,36,57,.632,15,41,.366,13,20,.650,130,38,93,.409,28,54,.519,10,39,.256,16,26,.615,102
283,SAC,2023-10-25,130,@,UTA,W 130-114,240,47,102,.461,28,51,.549,19,51,.373,17,20,.850,130,41,91,.451,32,63,.508,9,28,.321,23,31,.742,114
284,CHI,2024-04-12,129,@,WAS,W 129-127,240,48,98,.490,34,63,.540,14,35,.400,19,28,.679,129,45,86,.523,27,43,.628,18,43,.419,19,29,.655,127
285,CLE,2024-04-12,129,,IND,W 129-120,240,50,95,.526,37,63,.587,13,32,.406,16,23,.696,129,46,89,.517,37,57,.649,9,32,.281,19,22,.864,120
286,CLE,2024-04-02,129,@,UTA,W 129-113,240,46,85,.541,30,46,.652,16,39,.410,21,24,.875,129,41,85,.482,25,48,.521,16,37,.432,15,18,.833,113
287,BOS,2024-03-22,129,@,DET,W 129-102,240,47,89,.528,31,44,.705,16,45,.356,19,27,.704,129,42,83,.506,33,52,.635,9,31,.290,9,13,.692,102
288,PHO,2024-03-17,129,@,MIL,L 129-140,240,51,87,.586,37,54,.685,14,33,.424,13,15,.867,129,51,94,.543,27,53,.509,24,41,.585,14,14,1.000,140
289,IND,2024-03-13,129,,CHI,L 129-132 (OT),265,46,99,.465,32,54,.593,14,45,.311,23,28,.821,129,48,92,.522,38,64,.594,10,28,.357,26,32,.813,132
290,SAC,2024-03-12,129,,MIL,W 129-94,240,49,92,.533,31,52,.596,18,40,.450,13,16,.813,129,30,82,.366,23,43,.535,7,39,.179,27,35,.771,94
291,SAS,2024-03-07,129,@,SAC,L 129-131,240,46,91,.505,30,58,.517,16,33,.485,21,21,1.000,129,52,102,.510,42,70,.600,10,32,.313,17,18,.944,131
292,NOP,2024-03-01,129,,IND,W 129-102,240,48,86,.558,33,54,.611,15,32,.469,18,26,.692,129,40,95,.421,30,63,.476,10,32,.313,12,18,.667,102
293,BOS,2024-02-22,129,@,CHI,W 129-112,240,45,83,.542,22,36,.611,23,47,.489,16,21,.762,129,44,94,.468,34,66,.515,10,28,.357,14,16,.875,112
294,IND,2024-02-22,129,,DET,W 129-115,240,50,94,.532,37,64,.578,13,30,.433,16,19,.842,129,47,89,.528,35,59,.593,12,30,.400,9,18,.500,115
295,OKC,2024-02-22,129,,LAC,W 129-107,240,50,90,.556,33,55,.600,17,35,.486,12,17,.706,129,42,93,.452,30,61,.492,12,32,.375,11,13,.846,107
296,GSW,2024-02-12,129,@,UTA,W 129-107,240,48,100,.480,28,56,.500,20,44,.455,13,17,.765,129,41,92,.446,30,60,.500,11,32,.344,14,16,.875,107
297,WAS,2024-02-09,129,@,BOS,L 129-133,240,45,95,.474,25,48,.521,20,47,.426,19,21,.905,129,48,92,.522,37,58,.638,11,34,.324,26,28,.929,133
298,PHO,2024-02-08,129,,UTA,W 129-115,240,52,88,.591,38,59,.644,14,29,.483,11,16,.688,129,41,94,.436,29,59,.492,12,35,.343,21,31,.677,115
299,MIN,2024-02-08,129,@,MIL,W 129-105,240,48,87,.552,27,46,.587,21,41,.512,12,16,.750,129,40,81,.494,26,48,.542,14,33,.424,11,16,.688,105
300,HOU,2024-02-06,129,@,IND,L 129-132,240,50,97,.515,38,72,.528,12,25,.480,17,23,.739,129,54,86,.628,39,54,.722,15,32,.469,9,14,.643,132
301,CHI,2024-02-06,129,,MIN,W 129-123 (OT),265,45,93,.484,33,63,.524,12,30,.400,27,32,.844,129,42,92,.457,22,47,.468,20,45,.444,19,26,.731,123
302,MIL,2024-02-03,129,@,DAL,W 129-117,240,50,88,.568,38,58,.655,12,30,.400,17,25,.680,129,40,81,.494,24,42,.571,16,39,.410,21,23,.913,117
303,ATL,2024-02-02,129,,PHO,W 129-120,240,49,95,.516,32,51,.627,17,44,.386,14,18,.778,129,47,88,.534,33,51,.647,14,37,.378,12,14,.857,120
304,BOS,2024-01-30,129,,IND,W 129-124,240,47,87,.540,30,51,.588,17,36,.472,18,22,.818,129,50,108,.463,38,69,.551,12,39,.308,12,15,.800,124
305,ORL,2024-01-29,129,@,DAL,L 129-131,240,45,88,.511,27,50,.540,18,38,.474,21,28,.750,129,43,69,.623,30,42,.714,13,27,.481,32,43,.744,131
306,UTA,2024-01-18,129,,OKC,L 129-134,240,43,89,.483,30,57,.526,13,32,.406,30,36,.833,129,48,86,.558,34,54,.630,14,32,.438,24,28,.857,134
307,DET,2024-01-15,129,@,WAS,W 129-117,240,50,90,.556,38,59,.644,12,31,.387,17,23,.739,129,44,95,.463,25,54,.463,19,41,.463,10,11,.909,117
308,MIL,2024-01-13,129,,GSW,W 129-118,240,51,94,.543,38,63,.603,13,31,.419,14,17,.824,129,47,98,.480,32,62,.516,15,36,.417,9,14,.643,118
309,NOP,2023-12-31,129,,LAL,W 129-109,240,45,87,.517,28,53,.528,17,34,.500,22,27,.815,129,39,82,.476,29,50,.580,10,32,.313,21,25,.840,109
310,DET,2023-12-30,129,,TOR,W 129-127,240,41,82,.500,29,54,.537,12,28,.429,35,40,.875,129,46,91,.505,34,67,.507,12,24,.500,23,28,.821,127
311,OKC,2023-12-27,129,,NYK,W 129-120,240,49,90,.544,35,58,.603,14,32,.438,17,22,.773,129,41,82,.500,27,48,.563,14,34,.412,24,30,.800,120
312,PHO,2023-12-27,129,@,HOU,W 129-113,240,47,82,.573,33,49,.673,14,33,.424,21,26,.808,129,40,96,.417,23,55,.418,17,41,.415,16,22,.727,113
313,OKC,2023-12-26,129,,MIN,W 129-106,240,49,81,.605,31,42,.738,18,39,.462,13,16,.813,129,34,73,.466,22,46,.478,12,27,.444,26,32,.813,106
314,NYK,2023-12-25,129,,MIL,W 129-122,240,50,92,.543,42,66,.636,8,26,.308,21,26,.808,129,45,95,.474,32,53,.604,13,42,.310,19,24,.792,122
315,LAL,2023-12-23,129,@,OKC,W 129-120,240,47,90,.522,31,58,.534,16,32,.500,19,23,.826,129,46,95,.484,33,54,.611,13,41,.317,15,19,.789,120
316,GSW,2023-12-22,129,,WAS,W 129-118,240,47,97,.485,29,52,.558,18,45,.400,17,20,.850,129,44,97,.454,33,62,.532,11,35,.314,19,24,.792,118
317,SAS,2023-12-15,129,,LAL,W 129-115,240,47,95,.495,29,53,.547,18,42,.429,17,19,.895,129,43,89,.483,32,53,.604,11,36,.306,18,28,.643,115
318,PHI,2023-12-13,129,@,DET,W 129-111,240,45,87,.517,34,57,.596,11,30,.367,28,34,.824,129,39,88,.443,29,55,.527,10,33,.303,23,30,.767,111
319,CHI,2023-12-11,129,@,MIL,L 129-133 (OT),265,47,114,.412,32,80,.400,15,34,.441,20,25,.800,129,44,86,.512,29,49,.592,15,37,.405,30,37,.811,133
320,DEN,2023-12-11,129,@,ATL,W 129-122,240,47,88,.534,35,59,.593,12,29,.414,23,29,.793,129,44,96,.458,27,52,.519,17,44,.386,17,18,.944,122
321,MIA,2023-12-02,129,,IND,L 129-144,240,48,89,.539,36,64,.563,12,25,.480,21,24,.875,129,56,85,.659,40,53,.755,16,32,.500,16,20,.800,144
322,BRK,2023-12-02,129,,ORL,W 129-101,240,46,91,.505,32,57,.561,14,34,.412,23,31,.742,129,35,88,.398,26,59,.441,9,29,.310,22,27,.815,101
323,CHO,2023-11-30,129,@,BRK,W 129-128,240,46,91,.505,25,55,.455,21,36,.583,16,16,1.000,129,52,105,.495,38,69,.551,14,36,.389,10,15,.667,128
324,MIA,2023-11-22,129,@,CLE,W 129-96,240,46,88,.523,26,53,.491,20,35,.571,17,21,.810,129,36,77,.468,22,47,.468,14,30,.467,10,14,.714,96
325,WAS,2023-11-20,129,,MIL,L 129-142,240,55,99,.556,45,70,.643,10,29,.345,9,11,.818,129,55,94,.585,44,65,.677,11,29,.379,21,28,.750,142
326,NOP,2023-11-20,129,,SAC,W 129-93,240,50,92,.543,38,64,.594,12,28,.429,17,21,.810,129,33,87,.379,22,42,.524,11,45,.244,16,24,.667,93
327,SAC,2023-11-19,129,@,DAL,W 129-113,240,48,90,.533,31,50,.620,17,40,.425,16,21,.762,129,41,88,.466,29,54,.537,12,34,.353,19,26,.731,113
328,SAC,2023-11-17,129,@,SAS,W 129-120,240,46,85,.541,28,43,.651,18,42,.429,19,24,.792,129,43,92,.467,28,56,.500,15,36,.417,19,23,.826,120
329,NYK,2023-11-12,129,,CHO,W 129-107,240,47,87,.540,32,51,.627,15,36,.417,20,30,.667,129,44,94,.468,32,59,.542,12,35,.343,7,11,.636,107
330,MIL,2023-11-06,129,@,BRK,W 129-125,240,46,96,.479,30,48,.625,16,48,.333,21,24,.875,129,49,101,.485,33,56,.589,16,45,.356,11,13,.846,125
331,NYK,2024-04-09,128,@,CHI,W 128-117,240,46,83,.554,29,47,.617,17,36,.472,19,20,.950,128,47,88,.534,37,60,.617,10,28,.357,13,19,.684,117
332,LAL,2024-04-02,128,@,TOR,W 128-111,240,52,101,.515,34,60,.567,18,41,.439,6,12,.500,128,43,89,.483,33,57,.579,10,32,.313,15,21,.714,111
333,OKC,2024-03-29,128,,PHO,W 128-103,240,49,87,.563,33,57,.579,16,30,.533,14,14,1.000,128,39,87,.448,26,46,.565,13,41,.317,12,15,.800,103
334,LAL,2024-03-26,128,@,MIL,W 128-124 (2OT),290,42,108,.389,28,64,.438,14,44,.318,30,32,.938,128,49,119,.412,34,68,.500,15,51,.294,11,17,.647,124
335,DEN,2024-03-25,128,,MEM,W 128-103,240,48,90,.533,33,58,.569,15,32,.469,17,18,.944,128,37,94,.394,26,50,.520,11,44,.250,18,27,.667,103
336,PHO,2024-03-21,128,,ATL,W 128-115,240,41,74,.554,19,33,.576,22,41,.537,24,27,.889,128,40,91,.440,28,56,.500,12,35,.343,23,29,.793,115
337,GSW,2024-03-16,128,@,LAL,W 128-121,240,51,97,.526,37,63,.587,14,34,.412,12,15,.800,128,47,92,.511,35,58,.603,12,34,.353,15,18,.833,121
338,POR,2024-03-09,128,,TOR,W 128-118 (OT),265,49,103,.476,33,63,.524,16,40,.400,14,15,.933,128,43,91,.473,27,48,.563,16,43,.372,16,19,.842,118
339,OKC,2024-03-06,128,@,POR,W 128-120,240,43,74,.581,34,52,.654,9,22,.409,33,39,.846,128,41,81,.506,27,47,.574,14,34,.412,24,27,.889,120
340,UTA,2024-02-25,128,,SAS,W 128-109,240,46,90,.511,29,55,.527,17,35,.486,19,22,.864,128,42,91,.462,29,60,.483,13,31,.419,12,19,.632,109
341,GSW,2024-02-22,128,,LAL,W 128-110,240,50,107,.467,34,66,.515,16,41,.390,12,14,.857,128,43,88,.489,33,53,.623,10,35,.286,14,21,.667,110
342,MIN,2024-02-15,128,@,POR,W 128-91,240,46,89,.517,35,59,.593,11,30,.367,25,27,.926,128,31,83,.373,23,54,.426,8,29,.276,21,30,.700,91
343,DET,2024-02-08,128,@,POR,W 128-122 (OT),265,45,93,.484,29,66,.439,16,27,.593,22,31,.710,128,41,89,.461,30,59,.508,11,30,.367,29,33,.879,122
344,CLE,2024-01-31,128,,DET,W 128-121,240,47,89,.528,35,54,.648,12,35,.343,22,23,.957,128,45,81,.556,29,50,.580,16,31,.516,15,19,.789,121
345,CHO,2024-01-22,128,@,MIN,W 128-125,240,50,88,.568,36,51,.706,14,37,.378,14,18,.778,128,44,84,.524,26,43,.605,18,41,.439,19,25,.760,125
346,LAC,2024-01-16,128,,OKC,W 128-117,240,47,87,.540,27,44,.614,20,43,.465,14,23,.609,128,42,83,.506,26,49,.531,16,34,.471,17,20,.850,117
347,LAC,2024-01-12,128,@,MEM,W 128-119,240,49,89,.551,34,58,.586,15,31,.484,15,20,.750,128,41,95,.432,23,51,.451,18,44,.409,19,27,.704,119
348,DAL,2024-01-11,128,,NYK,W 128-124,240,44,88,.500,27,47,.574,17,41,.415,23,30,.767,128,44,89,.494,30,47,.638,14,42,.333,22,28,.786,124
349,OKC,2024-01-10,128,@,MIA,W 128-120,240,51,86,.593,37,53,.698,14,33,.424,12,16,.750,128,41,89,.461,26,53,.491,15,36,.417,23,28,.821,120
350,WAS,2024-01-08,128,,OKC,L 128-136,240,44,89,.494,29,57,.509,15,32,.469,25,29,.862,128,52,88,.591,38,60,.633,14,28,.500,18,24,.750,136
351,NYK,2024-01-05,128,@,PHI,W 128-92,240,43,89,.483,25,48,.521,18,41,.439,24,25,.960,128,33,81,.407,27,58,.466,6,23,.261,20,27,.741,92
352,SAS,2023-12-29,128,@,POR,L 128-134,240,48,94,.511,34,61,.557,14,33,.424,18,25,.720,128,48,95,.505,32,68,.471,16,27,.593,22,27,.815,134
353,BOS,2023-12-28,128,,DET,W 128-122 (OT),265,48,99,.485,37,60,.617,11,39,.282,21,25,.840,128,48,101,.475,34,58,.586,14,43,.326,12,19,.632,122
354,DAL,2023-12-25,128,@,PHO,W 128-114,240,45,84,.536,29,40,.725,16,44,.364,22,30,.733,128,40,90,.444,26,49,.531,14,41,.341,20,25,.800,114
355,MIL,2023-12-17,128,,HOU,W 128-119,240,45,90,.500,32,54,.593,13,36,.361,25,32,.781,128,45,85,.529,34,58,.586,11,27,.407,18,21,.857,119
356,BOS,2023-12-15,128,,ORL,W 128-111,240,48,92,.522,30,50,.600,18,42,.429,14,20,.700,128,42,87,.483,28,52,.538,14,35,.400,13,18,.722,111
357,SAC,2023-12-14,128,,OKC,W 128-123,240,47,95,.495,29,50,.580,18,45,.400,16,21,.762,128,44,102,.431,33,66,.500,11,36,.306,24,27,.889,123
358,ATL,2023-12-13,128,@,TOR,L 128-135,240,48,100,.480,30,59,.508,18,41,.439,14,19,.737,128,50,87,.575,32,53,.604,18,34,.529,17,24,.708,135
359,IND,2023-12-07,128,@,MIL,W 128-119,240,50,102,.490,43,69,.623,7,33,.212,21,25,.840,128,43,96,.448,31,63,.492,12,33,.364,21,28,.750,119
360,BRK,2023-11-30,128,,CHO,L 128-129,240,52,105,.495,38,69,.551,14,36,.389,10,15,.667,128,46,91,.505,25,55,.455,21,36,.583,16,16,1.000,129
361,CLE,2023-11-28,128,,ATL,W 128-105,240,50,93,.538,37,57,.649,13,36,.361,15,17,.882,128,35,101,.347,22,57,.386,13,44,.295,22,24,.917,105
362,WAS,2023-11-24,128,@,MIL,L 128-131,240,48,100,.480,33,63,.524,15,37,.405,17,21,.810,128,48,92,.522,39,61,.639,9,31,.290,26,33,.788,131
363,ORL,2023-11-19,128,@,IND,W 128-116,240,43,87,.494,36,67,.537,7,20,.350,35,42,.833,128,42,95,.442,34,64,.531,8,31,.258,24,31,.774,116
364,UTA,2023-11-17,128,,PHO,L 128-131,240,43,85,.506,27,49,.551,16,36,.444,26,31,.839,128,45,86,.523,27,53,.509,18,33,.545,23,26,.885,131
365,OKC,2023-11-16,128,@,GSW,W 128-109,240,44,87,.506,25,55,.455,19,32,.594,21,23,.913,128,40,98,.408,26,57,.456,14,41,.341,15,19,.789,109
366,MIL,2023-11-15,128,@,TOR,W 128-112,240,44,85,.518,24,46,.522,20,39,.513,20,21,.952,128,38,96,.396,29,63,.460,9,33,.273,27,31,.871,112
367,OKC,2023-11-08,128,,CLE,W 128-120,240,44,86,.512,32,58,.552,12,28,.429,28,30,.933,128,42,83,.506,33,54,.611,9,29,.310,27,37,.730,120
368,HOU,2023-11-08,128,,LAL,W 128-94,240,51,93,.548,37,60,.617,14,33,.424,12,19,.632,128,36,85,.424,29,60,.483,7,25,.280,15,24,.625,94
369,WAS,2023-11-06,128,@,PHI,L 128-146,240,49,96,.510,35,62,.565,14,34,.412,16,20,.800,128,51,91,.560,39,60,.650,12,31,.387,32,36,.889,146
370,HOU,2023-11-01,128,,CHO,W 128-119,240,44,84,.524,23,47,.489,21,37,.568,19,23,.826,128,45,90,.500,34,63,.540,11,27,.407,18,25,.720,119
371,DEN,2023-10-29,128,@,OKC,W 128-95,240,53,88,.602,42,61,.689,11,27,.407,11,13,.846,128,37,90,.411,31,58,.534,6,32,.188,15,18,.833,95
372,WAS,2024-04-12,127,,CHI,L 127-129,240,45,86,.523,27,43,.628,18,43,.419,19,29,.655,127,48,98,.490,34,63,.540,14,35,.400,19,28,.679,129
373,CHI,2024-04-11,127,@,DET,W 127-105,240,51,96,.531,37,60,.617,14,36,.389,11,15,.733,127,38,77,.494,24,42,.571,14,35,.400,15,23,.652,105
374,OKC,2024-04-10,127,,SAS,W 127-89,240,47,101,.465,31,63,.492,16,38,.421,17,21,.810,127,32,96,.333,23,56,.411,9,40,.225,16,20,.800,89
375,MIN,2024-04-07,127,@,LAL,W 127-117,240,50,97,.515,35,58,.603,15,39,.385,12,14,.857,127,39,84,.464,28,53,.528,11,31,.355,28,32,.875,117
376,SAC,2024-03-31,127,,UTA,W 127-106,240,45,84,.536,25,44,.568,20,40,.500,17,23,.739,127,34,83,.410,18,42,.429,16,41,.390,22,28,.786,106
377,HOU,2024-03-21,127,,CHI,W 127-117,240,47,93,.505,30,48,.625,17,45,.378,16,20,.800,127,42,93,.452,30,62,.484,12,31,.387,21,25,.840,117
378,CHI,2024-03-16,127,,WAS,W 127-98,240,49,85,.576,41,61,.672,8,24,.333,21,29,.724,127,36,84,.429,23,52,.442,13,32,.406,13,22,.591,98
379,BOS,2024-03-14,127,,PHO,W 127-112,240,47,89,.528,22,39,.564,25,50,.500,8,11,.727,127,47,99,.475,36,68,.529,11,31,.355,7,10,.700,112
380,DAL,2024-03-11,127,@,CHI,W 127-92,240,51,93,.548,38,52,.731,13,41,.317,12,15,.800,127,35,89,.393,28,55,.509,7,34,.206,15,22,.682,92
381,UTA,2024-03-04,127,,WAS,W 127-115,240,49,101,.485,33,61,.541,16,40,.400,13,15,.867,127,40,94,.426,24,56,.429,16,38,.421,19,23,.826,115
382,DEN,2024-02-23,127,@,POR,W 127-112,240,50,85,.588,37,52,.712,13,33,.394,14,22,.636,127,46,101,.455,38,76,.500,8,25,.320,12,18,.667,112
383,NOP,2024-02-22,127,,HOU,W 127-105,240,50,96,.521,34,55,.618,16,41,.390,11,18,.611,127,36,82,.439,21,41,.512,15,41,.366,18,28,.643,105
384,SAC,2024-02-22,127,,SAS,W 127-122,240,52,93,.559,39,60,.650,13,33,.394,10,14,.714,127,50,98,.510,39,73,.534,11,25,.440,11,16,.688,122
385,IND,2024-02-14,127,@,TOR,W 127-125,240,47,97,.485,30,56,.536,17,41,.415,16,23,.696,127,50,98,.510,44,72,.611,6,26,.231,19,26,.731,125
386,OKC,2024-02-13,127,@,ORL,W 127-113,240,46,84,.548,33,52,.635,13,32,.406,22,24,.917,127,41,91,.451,30,55,.545,11,36,.306,20,25,.800,113
387,OKC,2024-02-11,127,,SAC,W 127-113,240,46,85,.541,33,58,.569,13,27,.481,22,27,.815,127,44,90,.489,28,48,.583,16,42,.381,9,13,.692,113
388,ATL,2024-02-09,127,@,PHI,W 127-121,240,42,81,.519,26,45,.578,16,36,.444,27,33,.818,127,42,98,.429,27,53,.509,15,45,.333,22,29,.759,121
389,ORL,2024-02-08,127,,SAS,W 127-111,240,49,82,.598,33,55,.600,16,27,.593,13,20,.650,127,42,81,.519,31,46,.674,11,35,.314,16,17,.941,111
390,GSW,2024-02-07,127,@,PHI,W 127-104,240,47,94,.500,31,56,.554,16,38,.421,17,22,.773,127,41,98,.418,33,66,.500,8,32,.250,14,14,1.000,104
391,TOR,2024-02-04,127,@,OKC,L 127-135 (2OT),290,48,101,.475,34,66,.515,14,35,.400,17,21,.810,127,52,110,.473,29,47,.617,23,63,.365,8,8,1.000,135
392,PHI,2024-02-01,127,@,UTA,W 127-124,240,47,94,.500,33,62,.532,14,32,.438,19,21,.905,127,45,87,.517,33,51,.647,12,36,.333,22,25,.880,124
393,LAC,2024-01-26,127,@,TOR,W 127-107,240,48,95,.505,39,63,.619,9,32,.281,22,24,.917,127,44,96,.458,38,64,.594,6,32,.188,13,22,.591,107
394,LAC,2024-01-23,127,,LAL,W 127-116,240,52,88,.591,38,61,.623,14,27,.519,9,12,.750,127,45,92,.489,34,60,.567,11,32,.344,15,22,.682,116
395,HOU,2024-01-20,127,,UTA,W 127-126 (OT),265,50,117,.427,37,78,.474,13,39,.333,14,22,.636,127,48,105,.457,35,62,.565,13,43,.302,17,22,.773,126
396,WAS,2024-01-20,127,,SAS,L 127-131,240,49,103,.476,40,74,.541,9,29,.310,20,23,.870,127,51,96,.531,39,65,.600,12,31,.387,17,23,.739,131
397,LAL,2024-01-17,127,,DAL,W 127-110,240,49,91,.538,37,63,.587,12,28,.429,17,24,.708,127,42,91,.462,31,51,.608,11,40,.275,15,18,.833,110
398,PHO,2024-01-14,127,@,POR,W 127-116,240,46,76,.605,33,48,.688,13,28,.464,22,27,.815,127,40,89,.449,20,47,.426,20,42,.476,16,22,.727,116
399,WAS,2024-01-13,127,@,ATL,W 127-99,240,47,97,.485,35,65,.538,12,32,.375,21,26,.808,127,32,93,.344,21,53,.396,11,40,.275,24,33,.727,99
400,PHO,2024-01-11,127,@,LAL,W 127-109,240,46,93,.495,32,54,.593,14,39,.359,21,23,.913,127,40,80,.500,27,46,.587,13,34,.382,16,25,.640,109
Rk,Team,Date,PTS,,Opp,Result,MP,FG,FGA,FG%,2P,2PA,2P%,3P,3PA,3P%,FT,FTA,FT%,PTS,FG,FGA,FG%,2P,2PA,2P%,3P,3PA,3P%,FT,FTA,FT%,PTS
401,BOS,2024-01-10,127,,MIN,W 127-120 (OT),265,39,90,.433,20,43,.465,19,47,.404,30,31,.968,127,44,95,.463,30,61,.492,14,34,.412,18,20,.900,120
402,BRK,2024-01-07,127,,POR,L 127-134 (OT),265,46,91,.505,32,54,.593,14,37,.378,21,25,.840,127,45,95,.474,25,57,.439,20,38,.526,24,30,.800,134
403,MEM,2024-01-05,127,@,LAL,W 127-113,240,44,82,.537,21,37,.568,23,45,.511,16,20,.800,127,42,85,.494,32,57,.561,10,28,.357,19,27,.704,113
404,GSW,2024-01-04,127,,DEN,L 127-130,240,49,90,.544,34,54,.630,15,36,.417,14,16,.875,127,48,85,.565,39,59,.661,9,26,.346,25,29,.862,130
405,OKC,2024-01-02,127,,BOS,W 127-123,240,48,91,.527,30,51,.588,18,40,.450,13,17,.765,127,42,92,.457,27,52,.519,15,40,.375,24,29,.828,123
406,UTA,2024-01-01,127,,DAL,W 127-90,240,49,96,.510,37,52,.712,12,44,.273,17,18,.944,127,37,93,.398,26,53,.491,11,40,.275,5,10,.500,90
407,TOR,2023-12-30,127,@,DET,L 127-129,240,46,91,.505,34,67,.507,12,24,.500,23,28,.821,127,41,82,.500,29,54,.537,12,28,.429,35,40,.875,129
408,HOU,2023-12-29,127,,PHI,L 127-131,240,49,91,.538,35,61,.574,14,30,.467,15,21,.714,127,45,86,.523,33,53,.623,12,33,.364,29,33,.879,131
409,ORL,2023-12-26,127,@,WAS,W 127-119,240,49,93,.527,37,67,.552,12,26,.462,17,25,.680,127,43,87,.494,27,45,.600,16,42,.381,17,21,.810,119
410,HOU,2023-12-20,127,,ATL,L 127-134,240,44,89,.494,28,55,.509,16,34,.471,23,23,1.000,127,47,91,.516,30,51,.588,17,40,.425,23,28,.821,134
411,PHI,2023-12-20,127,,MIN,W 127-113,240,45,84,.536,37,62,.597,8,22,.364,29,32,.906,127,42,82,.512,33,57,.579,9,25,.360,20,24,.833,113
412,IND,2023-12-18,127,,LAC,L 127-151,240,49,95,.516,37,62,.597,12,33,.364,17,21,.810,127,56,98,.571,37,60,.617,19,38,.500,20,23,.870,151
413,MIN,2023-12-16,127,,IND,W 127-109,240,48,86,.558,30,56,.536,18,30,.600,13,16,.813,127,45,90,.500,39,69,.565,6,21,.286,13,16,.813,109
414,CLE,2023-12-16,127,,ATL,W 127-119,240,49,101,.485,33,59,.559,16,42,.381,13,15,.867,127,41,85,.482,26,49,.531,15,36,.417,22,25,.880,119
415,DAL,2023-12-12,127,,LAL,W 127-125,240,44,89,.494,23,46,.500,21,43,.488,18,21,.857,127,49,91,.538,34,62,.548,15,29,.517,12,18,.667,125
416,POR,2023-12-11,127,@,LAC,L 127-132,240,43,90,.478,24,50,.480,19,40,.475,22,26,.846,127,49,89,.551,36,55,.655,13,34,.382,21,22,.955,132
417,MIN,2023-12-08,127,@,MEM,W 127-103,240,44,88,.500,29,50,.580,15,38,.395,24,26,.923,127,37,86,.430,22,51,.431,15,35,.429,14,19,.737,103
418,NOP,2023-12-04,127,@,SAC,W 127-117,240,47,87,.540,33,56,.589,14,31,.452,19,23,.826,127,38,85,.447,24,44,.545,14,41,.341,27,33,.818,117
419,PHI,2023-11-25,127,@,OKC,W 127-123,240,38,83,.458,24,42,.571,14,41,.341,37,45,.822,127,43,98,.439,27,55,.491,16,43,.372,21,26,.808,123
420,UTA,2023-11-10,127,@,MEM,W 127-121,240,41,76,.539,23,39,.590,18,37,.486,27,29,.931,127,46,101,.455,27,53,.509,19,48,.396,10,13,.769,121
421,TOR,2023-11-08,127,@,DAL,W 127-116,240,49,99,.495,38,63,.603,11,36,.306,18,27,.667,127,40,84,.476,23,43,.535,17,41,.415,19,31,.613,116
422,ATL,2023-10-30,127,,MIN,W 127-113,240,48,86,.558,34,56,.607,14,30,.467,17,18,.944,127,44,90,.489,28,57,.491,16,33,.485,9,15,.600,113
423,LAL,2023-10-29,127,@,SAC,L 127-132 (OT),265,43,98,.439,28,53,.528,15,45,.333,26,34,.765,127,49,104,.471,32,56,.571,17,48,.354,17,24,.708,132
424,ATL,2023-10-29,127,@,MIL,W 127-110,240,47,93,.505,32,56,.571,15,37,.405,18,22,.818,127,39,86,.453,23,42,.548,16,44,.364,16,20,.800,110
425,DEN,2024-04-14,126,@,MEM,W 126-111,240,46,89,.517,34,53,.642,12,36,.333,22,26,.846,126,45,100,.450,37,67,.552,8,33,.242,13,18,.722,111
426,SAS,2024-04-07,126,,PHI,L 126-133 (2OT),290,44,98,.449,28,54,.519,16,44,.364,22,26,.846,126,52,114,.456,40,75,.533,12,39,.308,17,19,.895,133
427,IND,2024-04-05,126,,OKC,W 126-112,240,46,88,.523,31,53,.585,15,35,.429,19,21,.905,126,42,86,.488,34,56,.607,8,30,.267,20,24,.833,112
428,NYK,2024-03-29,126,@,SAS,L 126-130 (OT),265,51,110,.464,37,73,.507,14,37,.378,10,12,.833,126,44,82,.537,28,42,.667,16,40,.400,26,32,.813,130
429,OKC,2024-03-27,126,,HOU,L 126-132 (OT),265,47,96,.490,33,58,.569,14,38,.368,18,24,.750,126,50,104,.481,35,61,.574,15,43,.349,17,23,.739,132
430,NOP,2024-03-16,126,,POR,W 126-107,240,52,97,.536,39,64,.609,13,33,.394,9,10,.900,126,42,84,.500,30,51,.588,12,33,.364,11,12,.917,107
431,LAC,2024-03-14,126,@,CHI,W 126-111,240,48,80,.600,28,40,.700,20,40,.500,10,14,.714,126,41,86,.477,25,51,.490,16,35,.457,13,16,.813,111
432,OKC,2024-03-14,126,,DAL,W 126-119,240,45,86,.523,29,47,.617,16,39,.410,20,23,.870,126,43,84,.512,31,55,.564,12,29,.414,21,26,.808,119
433,SAS,2024-03-09,126,@,GSW,W 126-113,240,44,86,.512,27,53,.509,17,33,.515,21,28,.750,126,41,88,.466,31,58,.534,10,30,.333,21,29,.724,113
434,MIA,2024-03-02,126,,UTA,W 126-120,240,46,88,.523,33,54,.611,13,34,.382,21,25,.840,126,42,87,.483,28,52,.538,14,35,.400,22,26,.846,120
435,WAS,2024-02-14,126,@,NOP,L 126-133,240,44,92,.478,23,47,.489,21,45,.467,17,20,.850,126,50,89,.562,40,57,.702,10,32,.313,23,29,.793,133
436,ATL,2024-02-12,126,,CHI,L 126-136,240,44,94,.468,30,51,.588,14,43,.326,24,29,.828,126,51,92,.554,38,64,.594,13,28,.464,21,29,.724,136
437,OKC,2024-02-02,126,,CHO,W 126-106,240,44,75,.587,27,39,.692,17,36,.472,21,27,.778,126,41,92,.446,27,61,.443,14,31,.452,10,14,.714,106
438,ATL,2024-01-28,126,,TOR,W 126-125,240,44,95,.463,38,68,.559,6,27,.222,32,40,.800,126,41,89,.461,26,58,.448,15,31,.484,28,32,.875,125
439,MIL,2024-01-24,126,,CLE,W 126-116,240,45,90,.500,34,61,.557,11,29,.379,25,28,.893,126,46,91,.505,33,53,.623,13,38,.342,11,15,.733,116
440,CLE,2024-01-22,126,@,ORL,W 126-99,240,45,80,.563,25,42,.595,20,38,.526,16,22,.727,126,34,74,.459,23,45,.511,11,29,.379,20,30,.667,99
441,NYK,2024-01-20,126,,TOR,W 126-100,240,48,88,.545,34,49,.694,14,39,.359,16,20,.800,126,38,92,.413,27,58,.466,11,34,.324,13,23,.565,100
442,UTA,2024-01-20,126,@,HOU,L 126-127 (OT),265,48,105,.457,35,62,.565,13,43,.302,17,22,.773,126,50,117,.427,37,78,.474,13,39,.333,14,22,.636,127
443,IND,2024-01-18,126,@,SAC,W 126-121,240,49,89,.551,36,56,.643,13,33,.394,15,19,.789,126,44,85,.518,29,48,.604,15,37,.405,18,32,.563,121
444,PHI,2024-01-16,126,,DEN,W 126-121,240,43,76,.566,28,45,.622,15,31,.484,25,34,.735,126,45,89,.506,33,60,.550,12,29,.414,19,25,.760,121
445,IND,2024-01-12,126,@,ATL,W 126-108,240,53,79,.671,42,61,.689,11,18,.611,9,12,.750,126,40,89,.449,29,59,.492,11,30,.367,17,23,.739,108
446,LAC,2024-01-10,126,,TOR,W 126-120,240,49,93,.527,34,59,.576,15,34,.441,13,13,1.000,126,46,84,.548,34,54,.630,12,30,.400,16,18,.889,120
447,BOS,2024-01-05,126,,UTA,W 126-97,240,39,90,.433,22,41,.537,17,49,.347,31,36,.861,126,34,94,.362,28,60,.467,6,34,.176,23,34,.676,97
448,DAL,2024-01-03,126,,POR,W 126-97,240,42,84,.500,29,54,.537,13,30,.433,29,41,.707,126,34,87,.391,21,47,.447,13,40,.325,16,22,.727,97
449,WAS,2023-12-31,126,,ATL,L 126-130,240,46,98,.469,29,45,.644,17,53,.321,17,21,.810,126,47,95,.495,35,63,.556,12,32,.375,24,37,.649,130
450,NYK,2023-12-30,126,@,IND,L 126-140,240,45,95,.474,28,58,.483,17,37,.459,19,27,.704,126,50,85,.588,27,42,.643,23,43,.535,17,21,.810,140
451,BOS,2023-12-25,126,@,LAL,W 126-115,240,46,91,.505,33,49,.673,13,42,.310,21,28,.750,126,43,90,.478,30,58,.517,13,32,.406,16,21,.762,115
452,GSW,2023-12-23,126,,POR,W 126-106,240,48,83,.578,38,50,.760,10,33,.303,20,24,.833,126,38,84,.452,25,49,.510,13,35,.371,17,25,.680,106
453,BRK,2023-12-23,126,,DET,W 126-115,240,45,86,.523,35,62,.565,10,24,.417,26,32,.813,126,39,79,.494,24,44,.545,15,35,.429,22,29,.759,115
454,UTA,2023-12-23,126,@,TOR,W 126-119,240,48,91,.527,31,53,.585,17,38,.447,13,14,.929,126,45,94,.479,32,62,.516,13,32,.406,16,19,.842,119
455,BOS,2023-12-19,126,@,GSW,L 126-132 (OT),265,47,114,.412,30,56,.536,17,58,.293,15,17,.882,126,50,109,.459,30,59,.508,20,50,.400,12,14,.857,132
456,IND,2023-12-13,126,@,MIL,L 126-140,240,45,100,.450,34,64,.531,11,36,.306,25,32,.781,126,48,89,.539,41,62,.661,7,27,.259,37,48,.771,140
457,WAS,2023-12-06,126,,PHI,L 126-131,240,52,92,.565,38,57,.667,14,35,.400,8,8,1.000,126,47,92,.511,39,65,.600,8,27,.296,29,34,.853,131
458,OKC,2023-12-02,126,@,DAL,W 126-120,240,44,100,.440,24,56,.429,20,44,.455,18,22,.818,126,39,87,.448,20,35,.571,19,52,.365,23,35,.657,120
459,WAS,2023-11-27,126,@,DET,W 126-107,240,45,89,.506,35,60,.583,10,29,.345,26,28,.929,126,43,102,.422,35,64,.547,8,38,.211,13,19,.684,107
460,ORL,2023-11-21,126,,TOR,W 126-107,240,50,100,.500,38,69,.551,12,31,.387,14,20,.700,126,38,75,.507,24,47,.511,14,28,.500,17,22,.773,107
461,PHI,2023-11-17,126,@,ATL,W 126-116,240,43,88,.489,30,58,.517,13,30,.433,27,28,.964,126,40,89,.449,28,56,.500,12,33,.364,24,30,.800,116
462,PHI,2023-11-14,126,,IND,L 126-132,240,43,86,.500,37,64,.578,6,22,.273,34,35,.971,126,48,93,.516,35,56,.625,13,37,.351,23,33,.697,132
463,ATL,2023-11-14,126,@,DET,W 126-120,240,45,87,.517,33,54,.611,12,33,.364,24,26,.923,126,47,90,.522,37,61,.607,10,29,.345,16,23,.696,120
464,IND,2023-11-12,126,@,PHI,L 126-137,240,47,90,.522,31,51,.608,16,39,.410,16,19,.842,126,53,105,.505,39,72,.542,14,33,.424,17,20,.850,137
465,LAC,2023-11-10,126,@,DAL,L 126-144,240,43,88,.489,35,61,.574,8,27,.296,32,36,.889,126,51,98,.520,32,56,.571,19,42,.452,23,26,.885,144
466,IND,2023-11-09,126,,MIL,W 126-124,240,44,92,.478,24,44,.545,20,48,.417,18,20,.900,126,46,87,.529,37,60,.617,9,27,.333,23,26,.885,124
467,NYK,2023-11-08,126,,SAS,W 126-105,240,46,100,.460,27,58,.466,19,42,.452,15,22,.682,126,44,90,.489,35,56,.625,9,34,.265,8,13,.615,105
468,OKC,2023-11-06,126,,ATL,W 126-117,240,45,94,.479,31,59,.525,14,35,.400,22,23,.957,126,38,102,.373,24,60,.400,14,42,.333,27,32,.844,117
469,BOS,2023-10-30,126,@,WAS,W 126-107,240,51,102,.500,32,49,.653,19,53,.358,5,7,.714,126,39,87,.448,28,51,.549,11,36,.306,18,26,.692,107
470,PHI,2023-10-29,126,,POR,W 126-98,240,40,82,.488,29,54,.537,11,28,.393,35,40,.875,126,36,94,.383,29,63,.460,7,31,.226,19,22,.864,98
471,PHO,2023-10-28,126,,UTA,W 126-104,240,45,85,.529,35,48,.729,10,37,.270,26,28,.929,126,40,91,.440,28,54,.519,12,37,.324,12,14,.857,104
472,SAS,2023-10-27,126,,HOU,W 126-122 (OT),265,46,94,.489,33,52,.635,13,42,.310,21,28,.750,126,52,100,.520,44,68,.647,8,32,.250,10,20,.500,122
473,NYK,2023-10-27,126,@,ATL,W 126-120,240,43,90,.478,23,46,.500,20,44,.455,20,28,.714,126,42,87,.483,30,55,.545,12,32,.375,24,30,.800,120
474,DAL,2023-10-25,126,@,SAS,W 126-119,240,47,99,.475,32,52,.615,15,47,.319,17,23,.739,126,46,89,.517,35,54,.648,11,35,.314,16,22,.727,119
475,PHO,2024-04-14,125,@,MIN,W 125-106,240,47,86,.547,31,57,.544,16,29,.552,15,18,.833,125,36,70,.514,27,44,.614,9,26,.346,25,31,.806,106
476,OKC,2024-04-12,125,,MIL,W 125-107,240,47,89,.528,34,51,.667,13,38,.342,18,20,.900,125,42,85,.494,31,55,.564,11,30,.367,12,13,.923,107
477,PHI,2024-04-12,125,,ORL,W 125-113,240,42,88,.477,24,51,.471,18,37,.486,23,28,.821,125,43,95,.453,35,68,.515,8,27,.296,19,25,.760,113
478,MIA,2024-04-12,125,,TOR,W 125-103,240,45,86,.523,28,45,.622,17,41,.415,18,23,.783,125,37,77,.481,27,46,.587,10,31,.323,19,22,.864,103
479,LAL,2024-04-03,125,@,WAS,W 125-120,240,46,91,.505,38,63,.603,8,28,.286,25,29,.862,125,45,91,.495,27,49,.551,18,42,.429,12,13,.923,120
480,DAL,2024-03-31,125,@,HOU,W 125-107,240,48,93,.516,24,46,.522,24,47,.511,5,9,.556,125,39,92,.424,26,54,.481,13,38,.342,16,19,.842,107
481,BRK,2024-03-29,125,,CHI,W 125-108,240,43,91,.473,18,47,.383,25,44,.568,14,22,.636,125,38,75,.507,29,45,.644,9,30,.300,23,29,.793,108
482,CHI,2024-03-27,125,,IND,W 125-99,240,49,98,.500,37,71,.521,12,27,.444,15,18,.833,125,34,85,.400,21,43,.488,13,42,.310,18,23,.783,99
483,LAC,2024-03-22,125,@,POR,W 125-117,240,44,77,.571,30,44,.682,14,33,.424,23,27,.852,125,45,93,.484,33,60,.550,12,33,.364,15,25,.600,117
484,DEN,2024-03-11,125,,TOR,W 125-119,240,52,95,.547,42,66,.636,10,29,.345,11,18,.611,125,47,93,.505,36,63,.571,11,30,.367,14,17,.824,119
485,CHI,2024-03-07,125,@,GSW,W 125-122,240,46,87,.529,30,51,.588,16,36,.444,17,23,.739,125,44,97,.454,33,55,.600,11,42,.262,23,28,.821,122
486,GSW,2024-03-06,125,,MIL,W 125-90,240,51,91,.560,32,52,.615,19,39,.487,4,7,.571,125,34,89,.382,23,50,.460,11,39,.282,11,15,.733,90
487,TOR,2024-02-28,125,,DAL,L 125-136,240,46,98,.469,33,63,.524,13,35,.371,20,30,.667,125,52,96,.542,37,53,.698,15,43,.349,17,21,.810,136
488,TOR,2024-02-14,125,,IND,L 125-127,240,50,98,.510,44,72,.611,6,26,.231,19,26,.731,125,47,97,.485,30,56,.536,17,41,.415,16,23,.696,127
489,GSW,2024-02-14,125,,LAC,L 125-130,240,47,103,.456,29,56,.518,18,47,.383,13,18,.722,125,44,88,.500,31,50,.620,13,38,.342,29,37,.784,130
490,SAC,2024-02-13,125,@,PHO,L 125-130,240,49,95,.516,40,64,.625,9,31,.290,18,24,.750,125,44,85,.518,31,54,.574,13,31,.419,29,36,.806,130
491,LAL,2024-02-13,125,,DET,W 125-111,240,43,84,.512,29,49,.592,14,35,.400,25,30,.833,125,45,108,.417,37,80,.463,8,28,.286,13,17,.765,111
492,IND,2024-02-10,125,@,NYK,W 125-111,240,50,82,.610,36,53,.679,14,29,.483,11,19,.579,125,40,84,.476,30,52,.577,10,32,.313,21,23,.913,111
493,BOS,2024-02-07,125,,ATL,W 125-117,240,49,93,.527,32,44,.727,17,49,.347,10,11,.909,125,43,102,.422,30,61,.492,13,41,.317,18,20,.900,117
494,DET,2024-02-02,125,,LAC,L 125-136,240,45,89,.506,28,49,.571,17,40,.425,18,24,.750,125,53,89,.596,39,60,.650,14,29,.483,16,19,.842,136
495,LAC,2024-01-31,125,@,WAS,W 125-109,240,47,100,.470,35,70,.500,12,30,.400,19,22,.864,125,45,97,.464,36,68,.529,9,29,.310,10,15,.667,109
496,TOR,2024-01-28,125,@,ATL,L 125-126,240,41,89,.461,26,58,.448,15,31,.484,28,32,.875,125,44,95,.463,38,68,.559,6,27,.222,32,40,.800,126
497,NYK,2024-01-27,125,,MIA,W 125-109,240,45,87,.517,28,54,.519,17,33,.515,18,26,.692,125,41,88,.466,27,51,.529,14,37,.378,13,16,.813,109
498,MIN,2024-01-22,125,,CHO,L 125-128,240,44,84,.524,26,43,.605,18,41,.439,19,25,.760,125,50,88,.568,36,51,.706,14,37,.378,14,18,.778,128
499,LAC,2024-01-21,125,,BRK,W 125-114,240,42,83,.506,29,57,.509,13,26,.500,28,33,.848,125,44,90,.489,30,51,.588,14,39,.359,12,16,.750,114
500,CHI,2024-01-20,125,,MEM,W 125-96,240,47,91,.516,33,58,.569,14,33,.424,17,21,.810,125,32,75,.427,19,33,.576,13,42,.310,19,23,.826,96
501,DAL,2024-01-15,125,,NOP,W 125-120,240,39,85,.459,21,42,.500,18,43,.419,29,35,.829,125,41,81,.506,34,58,.586,7,23,.304,31,41,.756,120
502,LAL,2024-01-13,125,@,UTA,L 125-132,240,46,92,.500,33,63,.524,13,29,.448,20,24,.833,125,42,93,.452,30,56,.536,12,37,.324,36,39,.923,132
503,DEN,2024-01-12,125,,NOP,W 125-113,240,50,90,.556,36,57,.632,14,33,.424,11,15,.733,125,42,89,.472,29,56,.518,13,33,.394,16,22,.727,113
504,MIL,2024-01-04,125,@,SAS,W 125-121,240,49,92,.533,37,58,.638,12,34,.353,15,19,.789,125,46,95,.484,32,55,.582,14,40,.350,15,17,.882,121
505,MEM,2023-12-23,125,@,ATL,W 125-119,240,50,97,.515,39,64,.609,11,33,.333,14,22,.636,125,45,96,.469,32,53,.604,13,43,.302,16,20,.800,119
506,UTA,2023-12-18,125,,BRK,W 125-108,240,45,91,.495,31,57,.544,14,34,.412,21,24,.875,125,39,90,.433,23,51,.451,16,39,.410,14,20,.700,108
507,SAC,2023-12-16,125,,UTA,W 125-104,240,46,85,.541,24,40,.600,22,45,.489,11,15,.733,125,38,86,.442,26,49,.531,12,37,.324,16,21,.762,104
508,ATL,2023-12-15,125,@,TOR,W 125-104,240,52,101,.515,36,60,.600,16,41,.390,5,6,.833,125,40,77,.519,30,46,.652,10,31,.323,14,25,.560,104
509,LAL,2023-12-12,125,@,DAL,L 125-127,240,49,91,.538,34,62,.548,15,29,.517,12,18,.667,125,44,89,.494,23,46,.500,21,43,.488,18,21,.857,127
510,PHI,2023-12-08,125,,ATL,W 125-114,240,42,87,.483,31,57,.544,11,30,.367,30,37,.811,125,41,104,.394,28,65,.431,13,39,.333,19,21,.905,114
511,DAL,2023-12-08,125,@,POR,W 125-112,240,47,91,.516,35,52,.673,12,39,.308,19,22,.864,125,39,105,.371,21,52,.404,18,53,.340,16,18,.889,112
512,BOS,2023-12-01,125,,PHI,W 125-119,240,39,77,.506,23,44,.523,16,33,.485,31,36,.861,125,43,94,.457,27,59,.458,16,35,.457,17,23,.739,119
513,WAS,2023-12-01,125,@,ORL,L 125-130,240,45,89,.506,32,61,.525,13,28,.464,22,31,.710,125,46,89,.517,34,58,.586,12,31,.387,26,33,.788,130
514,DAL,2023-11-18,125,@,MIL,L 125-132,240,51,103,.495,35,56,.625,16,47,.340,7,10,.700,125,49,94,.521,32,49,.653,17,45,.378,17,20,.850,132
515,SAC,2023-11-15,125,@,LAL,W 125-110,240,48,96,.500,32,52,.615,16,44,.364,13,17,.765,125,42,83,.506,31,54,.574,11,29,.379,15,19,.789,110
516,BRK,2023-11-06,125,,MIL,L 125-129,240,49,101,.485,33,56,.589,16,45,.356,11,13,.846,125,46,96,.479,30,48,.625,16,48,.333,21,24,.875,129
517,CHO,2023-11-04,125,@,IND,W 125-124,240,47,88,.534,39,68,.574,8,20,.400,23,23,1.000,125,45,93,.484,23,48,.479,22,45,.489,12,16,.750,124
518,DEN,2023-11-03,125,,DAL,W 125-114,240,49,93,.527,36,63,.571,13,30,.433,14,19,.737,125,41,86,.477,24,44,.545,17,42,.405,15,17,.882,114
519,NOP,2023-11-02,125,,DET,W 125-116,240,39,80,.488,25,48,.521,14,32,.438,33,35,.943,125,41,94,.436,28,56,.500,13,38,.342,21,26,.808,116
520,LAC,2023-11-01,125,@,LAL,L 125-130 (OT),265,47,99,.475,33,65,.508,14,34,.412,17,27,.630,125,46,90,.511,35,58,.603,11,32,.344,27,36,.750,130
521,DAL,2023-10-30,125,@,MEM,W 125-110,240,42,84,.500,19,37,.514,23,47,.489,18,24,.750,125,42,92,.457,28,55,.509,14,37,.378,12,20,.600,110
522,IND,2023-10-28,125,@,CLE,W 125-113,240,48,98,.490,33,60,.550,15,38,.395,14,17,.824,125,43,99,.434,31,68,.456,12,31,.387,15,24,.625,113
523,DAL,2023-10-27,125,,BRK,W 125-120,240,44,91,.484,29,55,.527,15,36,.417,22,28,.786,125,45,92,.489,24,49,.490,21,43,.488,9,10,.900,120
524,LAL,2024-04-14,124,@,NOP,W 124-108,240,48,87,.552,37,58,.638,11,29,.379,17,18,.944,124,41,86,.477,26,49,.531,15,37,.405,11,14,.786,108
525,UTA,2024-04-11,124,,HOU,W 124-121,240,44,87,.506,30,48,.625,14,39,.359,22,27,.815,124,40,95,.421,19,48,.396,21,47,.447,20,22,.909,121
526,PHO,2024-04-10,124,@,LAC,W 124-108,240,46,95,.484,28,45,.622,18,50,.360,14,15,.933,124,44,95,.463,32,59,.542,12,36,.333,8,10,.800,108
527,BOS,2024-04-07,124,,POR,W 124-107,240,49,87,.563,33,49,.673,16,38,.421,10,13,.769,124,40,102,.392,26,64,.406,14,38,.368,13,13,1.000,107
528,CHO,2024-04-05,124,,ORL,W 124-115,240,43,72,.597,28,42,.667,15,30,.500,23,23,1.000,124,42,94,.447,33,56,.589,9,38,.237,22,26,.846,115
529,PHO,2024-04-01,124,@,NOP,W 124-111,240,43,87,.494,25,40,.625,18,47,.383,20,25,.800,124,42,89,.472,31,62,.500,11,27,.407,16,24,.667,111
530,MEM,2024-03-27,124,,LAL,L 124-136,240,46,97,.474,29,54,.537,17,43,.395,15,19,.789,124,45,81,.556,27,48,.563,18,33,.545,28,35,.800,136
531,MIL,2024-03-26,124,,LAL,L 124-128 (2OT),290,49,119,.412,34,68,.500,15,51,.294,11,17,.647,124,42,108,.389,28,64,.438,14,44,.318,30,32,.938,128
532,NYK,2024-03-25,124,,DET,W 124-99,240,45,89,.506,26,43,.605,19,46,.413,15,22,.682,124,34,88,.386,24,54,.444,10,34,.294,21,22,.955,99
533,BOS,2024-03-23,124,@,CHI,W 124-113,240,44,86,.512,23,38,.605,21,48,.438,15,17,.882,124,47,82,.573,38,58,.655,9,24,.375,10,11,.909,113
534,UTA,2024-03-15,124,,ATL,W 124-122,240,46,90,.511,32,54,.593,14,36,.389,18,20,.900,124,41,92,.446,21,53,.396,20,39,.513,20,27,.741,122
535,OKC,2024-03-10,124,,MEM,W 124-93,240,49,93,.527,28,46,.609,21,47,.447,5,5,1.000,124,32,78,.410,21,45,.467,11,33,.333,18,27,.667,93
536,MIL,2024-03-10,124,@,LAC,W 124-117,240,43,87,.494,26,49,.531,17,38,.447,21,27,.778,124,47,104,.452,33,57,.579,14,47,.298,9,10,.900,117
537,DET,2024-03-09,124,,DAL,L 124-142,240,45,99,.455,32,62,.516,13,37,.351,21,25,.840,124,51,92,.554,37,54,.685,14,38,.368,26,32,.813,142
538,DEN,2024-03-02,124,@,LAL,W 124-114,240,54,92,.587,43,66,.652,11,26,.423,5,7,.714,124,47,89,.528,35,60,.583,12,29,.414,8,11,.727,114
539,SAC,2024-03-01,124,@,MIN,W 124-120 (OT),265,50,100,.500,39,71,.549,11,29,.379,13,24,.542,124,42,85,.494,30,54,.556,12,31,.387,24,32,.750,120
540,BRK,2024-02-29,124,,ATL,W 124-97,240,46,90,.511,24,44,.545,22,46,.478,10,13,.769,124,37,86,.430,29,58,.500,8,28,.286,15,21,.714,97
541,ATL,2024-02-27,124,,UTA,W 124-97,240,46,93,.495,34,61,.557,12,32,.375,20,23,.870,124,35,94,.372,24,56,.429,11,38,.289,16,19,.842,97
542,UTA,2024-02-06,124,,OKC,W 124-117,240,46,89,.517,32,54,.593,14,35,.400,18,20,.900,124,43,90,.478,24,53,.453,19,37,.514,12,18,.667,117
543,LAL,2024-02-05,124,@,CHO,W 124-118,240,50,89,.562,42,55,.764,8,34,.235,16,19,.842,124,47,96,.490,34,64,.531,13,32,.406,11,14,.786,118
544,UTA,2024-02-01,124,,PHI,L 124-127,240,45,87,.517,33,51,.647,12,36,.333,22,25,.880,124,47,94,.500,33,62,.532,14,32,.438,19,21,.905,127
545,IND,2024-01-30,124,@,BOS,L 124-129,240,50,108,.463,38,69,.551,12,39,.308,12,15,.800,124,47,87,.540,30,51,.588,17,36,.472,18,22,.818,129
546,UTA,2024-01-23,124,@,NOP,L 124-153,240,43,92,.467,31,56,.554,12,36,.333,26,32,.813,124,60,104,.577,37,58,.638,23,46,.500,10,15,.667,153
547,PHI,2024-01-19,124,@,ORL,W 124-109,240,42,87,.483,29,57,.509,13,30,.433,27,29,.931,124,37,78,.474,27,55,.491,10,23,.435,25,27,.926,109
548,CHO,2024-01-19,124,,SAS,W 124-120,240,47,84,.560,31,55,.564,16,29,.552,14,16,.875,124,47,84,.560,32,52,.615,15,32,.469,11,17,.647,120
549,MIN,2024-01-17,124,@,DET,W 124-117,240,47,93,.505,32,63,.508,15,30,.500,15,21,.714,124,46,89,.517,34,58,.586,12,31,.387,13,19,.684,117
550,PHI,2024-01-15,124,,HOU,W 124-115,240,40,83,.482,25,52,.481,15,31,.484,29,34,.853,124,44,88,.500,36,61,.590,8,27,.296,19,32,.594,115
551,NYK,2024-01-11,124,@,DAL,L 124-128,240,44,89,.494,30,47,.638,14,42,.333,22,28,.786,124,44,88,.500,27,47,.574,17,41,.415,23,30,.767,128
552,CHI,2024-01-10,124,,HOU,W 124-119 (OT),265,42,95,.442,23,48,.479,19,47,.404,21,25,.840,124,48,101,.475,37,56,.661,11,45,.244,12,20,.600,119
553,UTA,2024-01-10,124,,DEN,W 124-111,240,46,83,.554,33,50,.660,13,33,.394,19,23,.826,124,37,81,.457,24,48,.500,13,33,.394,24,28,.857,111
554,BRK,2024-01-05,124,,OKC,W 124-115,240,41,91,.451,27,52,.519,14,39,.359,28,33,.848,124,45,84,.536,36,53,.679,9,31,.290,16,24,.667,115
555,TOR,2024-01-01,124,,CLE,W 124-121,240,42,87,.483,31,57,.544,11,30,.367,29,40,.725,124,43,89,.483,31,53,.585,12,36,.333,23,26,.885,121
556,OKC,2023-12-31,124,,BRK,W 124-108,240,45,83,.542,27,50,.540,18,33,.545,16,20,.800,124,38,100,.380,26,54,.481,12,46,.261,20,31,.645,108
557,CHI,2023-12-20,124,,LAL,W 124-108,240,48,88,.545,30,54,.556,18,34,.529,10,11,.909,124,42,94,.447,30,57,.526,12,37,.324,12,15,.800,108
558,CLE,2023-12-20,124,,UTA,W 124-116,240,45,96,.469,22,45,.489,23,51,.451,11,16,.688,124,40,78,.513,27,48,.563,13,30,.433,23,28,.821,116
559,DET,2023-12-18,124,@,ATL,L 124-130,240,48,94,.511,39,72,.542,9,22,.409,19,27,.704,124,46,85,.541,30,49,.612,16,36,.444,22,27,.815,130
560,GSW,2023-12-16,124,,BRK,W 124-120,240,44,91,.484,27,59,.458,17,32,.531,19,20,.950,124,45,93,.484,28,50,.560,17,43,.395,13,15,.867,120
561,PHI,2023-12-15,124,,DET,W 124-92,240,41,98,.418,27,61,.443,14,37,.378,28,31,.903,124,35,81,.432,31,60,.517,4,21,.190,18,23,.783,92
562,CHI,2023-12-14,124,@,MIA,W 124-116,240,45,93,.484,31,57,.544,14,36,.389,20,30,.667,124,37,80,.463,22,46,.478,15,34,.441,27,35,.771,116
563,DEN,2023-12-14,124,,BRK,W 124-101,240,47,99,.475,35,63,.556,12,36,.333,18,21,.857,124,39,95,.411,31,65,.477,8,30,.267,15,20,.750,101
564,BRK,2023-12-08,124,,WAS,W 124-97,240,50,104,.481,40,71,.563,10,33,.303,14,18,.778,124,38,91,.418,32,58,.552,6,33,.182,15,21,.714,97
565,CHI,2023-12-02,124,,NOP,W 124-118,240,48,88,.545,31,48,.646,17,40,.425,11,15,.733,124,41,82,.500,33,57,.579,8,25,.320,28,35,.800,118
566,HOU,2023-11-29,124,@,DEN,L 124-134,240,47,86,.547,31,45,.689,16,41,.390,14,19,.737,124,48,95,.505,29,52,.558,19,43,.442,19,26,.731,134
567,NOP,2023-11-29,124,,PHI,W 124-114,240,42,78,.538,32,48,.667,10,30,.333,30,34,.882,124,42,81,.519,28,47,.596,14,34,.412,16,18,.889,114
568,BOS,2023-11-28,124,,CHI,W 124-97,240,47,90,.522,26,41,.634,21,49,.429,9,12,.750,124,39,90,.433,30,62,.484,9,28,.321,10,18,.556,97
569,SAC,2023-11-28,124,,GSW,W 124-123,240,41,91,.451,26,47,.553,15,44,.341,27,42,.643,124,40,83,.482,23,42,.548,17,41,.415,26,30,.867,123
570,MIA,2023-11-28,124,,MIL,L 124-131,240,48,94,.511,34,64,.531,14,30,.467,14,21,.667,124,47,88,.534,34,53,.642,13,35,.371,24,27,.889,131
571,SAC,2023-11-24,124,@,MIN,W 124-111,240,49,100,.490,32,65,.492,17,35,.486,9,11,.818,124,36,82,.439,24,49,.490,12,33,.364,27,29,.931,111
572,ORL,2023-11-22,124,,DEN,W 124-119,240,44,81,.543,34,52,.654,10,29,.345,26,30,.867,124,44,93,.473,29,58,.500,15,35,.429,16,21,.762,119
573,LAC,2023-11-20,124,@,SAS,W 124-99,240,45,95,.474,33,59,.559,12,36,.333,22,25,.880,124,39,90,.433,29,52,.558,10,38,.263,11,14,.786,99
574,BRK,2023-11-14,124,,ORL,W 124-104,240,46,85,.541,27,46,.587,19,39,.487,13,20,.650,124,36,82,.439,20,36,.556,16,46,.348,16,21,.762,104
575,NOP,2023-11-12,124,,DAL,L 124-136,240,47,92,.511,30,56,.536,17,36,.472,13,22,.591,124,50,102,.490,30,49,.612,20,53,.377,16,21,.762,136
576,CHO,2023-11-10,124,@,WAS,W 124-117,240,50,110,.455,44,82,.537,6,28,.214,18,28,.643,124,43,88,.489,29,50,.580,14,38,.368,17,20,.850,117
577,MIL,2023-11-09,124,@,IND,L 124-126,240,46,87,.529,37,60,.617,9,27,.333,23,26,.885,124,44,92,.478,24,44,.545,20,48,.417,18,20,.900,126
578,DAL,2023-11-05,124,,CHO,W 124-118,240,43,91,.473,29,49,.592,14,42,.333,24,32,.750,124,49,99,.495,41,69,.594,8,30,.267,12,21,.571,118
579,BOS,2023-11-04,124,@,BRK,W 124-114,240,43,90,.478,28,45,.622,15,45,.333,23,27,.852,124,43,100,.430,26,48,.542,17,52,.327,11,17,.647,114
580,IND,2023-11-04,124,,CHO,L 124-125,240,45,93,.484,23,48,.479,22,45,.489,12,16,.750,124,47,88,.534,39,68,.574,8,20,.400,23,23,1.000,125
581,OKC,2023-10-30,124,,DET,W 124-112,240,44,83,.530,31,54,.574,13,29,.448,23,28,.821,124,39,91,.429,24,63,.381,15,28,.536,19,24,.792,112
582,OKC,2023-10-25,124,@,CHI,W 124-104,240,45,82,.549,26,43,.605,19,39,.487,15,18,.833,124,39,94,.415,27,52,.519,12,42,.286,14,18,.778,104
583,GSW,2024-04-14,123,,UTA,W 123-116,240,45,94,.479,31,51,.608,14,43,.326,19,23,.826,123,46,89,.517,32,55,.582,14,34,.412,10,16,.625,116
584,SAS,2024-04-14,123,,DET,W 123-95,240,49,91,.538,34,57,.596,15,34,.441,10,14,.714,123,36,92,.391,28,59,.475,8,33,.242,15,20,.750,95
585,LAL,2024-04-12,123,@,MEM,W 123-120,240,42,81,.519,29,44,.659,13,37,.351,26,34,.765,123,43,95,.453,26,56,.464,17,39,.436,17,21,.810,120
586,SAC,2024-04-11,123,,NOP,L 123-135,240,46,84,.548,30,46,.652,16,38,.421,15,20,.750,123,49,86,.570,27,46,.587,22,40,.550,15,18,.833,135
587,TOR,2024-04-09,123,,IND,L 123-140,240,47,94,.500,42,73,.575,5,21,.238,24,33,.727,123,54,99,.545,38,54,.704,16,45,.356,16,23,.696,140
588,ATL,2024-03-28,123,,BOS,W 123-122 (OT),265,51,104,.490,36,60,.600,15,44,.341,6,10,.600,123,45,94,.479,31,58,.534,14,36,.389,18,21,.857,122
589,OKC,2024-03-22,123,@,TOR,W 123-103,240,48,95,.505,36,63,.571,12,32,.375,15,19,.789,123,40,76,.526,29,46,.630,11,30,.367,12,17,.706,103
590,IND,2024-03-22,123,@,GSW,W 123-111,240,48,99,.485,33,63,.524,15,36,.417,12,16,.750,123,43,106,.406,29,58,.500,14,48,.292,11,16,.688,111
591,SAC,2024-03-20,123,@,TOR,W 123-89,240,48,93,.516,36,53,.679,12,40,.300,15,18,.833,123,33,80,.413,23,49,.469,10,31,.323,13,18,.722,89
592,BOS,2024-03-12,123,@,UTA,W 123-107,240,43,92,.467,23,43,.535,20,49,.408,17,19,.895,123,41,86,.477,26,54,.481,15,32,.469,10,11,.909,107
593,HOU,2024-03-08,123,@,POR,W 123-107,240,45,94,.479,31,57,.544,14,37,.378,19,26,.731,123,37,89,.416,21,54,.389,16,35,.457,17,25,.680,107
594,LAL,2024-03-08,123,,MIL,W 123-122,240,47,90,.522,31,56,.554,16,34,.471,13,19,.684,123,46,93,.495,30,52,.577,16,41,.390,14,17,.824,122
595,IND,2024-02-28,123,,NOP,W 123-114,240,50,102,.490,36,64,.563,14,38,.368,9,9,1.000,123,42,90,.467,31,61,.508,11,29,.379,19,23,.826,114
596,CLE,2024-02-28,123,@,CHI,L 123-132 (2OT),290,45,104,.433,23,50,.460,22,54,.407,11,19,.579,123,44,110,.400,31,73,.425,13,37,.351,31,38,.816,132
597,GSW,2024-02-27,123,@,WAS,W 123-112,240,47,94,.500,26,48,.542,21,46,.457,8,11,.727,123,46,93,.495,34,58,.586,12,35,.343,8,10,.800,112
598,MIL,2024-02-27,123,,CHO,W 123-85,240,46,89,.517,30,49,.612,16,40,.400,15,18,.833,123,30,81,.370,19,41,.463,11,40,.275,14,17,.824,85
599,OKC,2024-02-25,123,@,HOU,W 123-110,240,46,97,.474,29,62,.468,17,35,.486,14,15,.933,123,38,93,.409,22,52,.423,16,41,.390,18,23,.783,110
600,PHO,2024-02-25,123,,LAL,W 123-113,240,44,93,.473,27,53,.509,17,40,.425,18,19,.947,123,47,90,.522,32,55,.582,15,35,.429,4,8,.500,113
601,SAC,2024-02-25,123,@,LAC,W 123-107,240,45,91,.495,30,54,.556,15,37,.405,18,22,.818,123,40,82,.488,32,55,.582,8,27,.296,19,20,.950,107
602,LAL,2024-02-23,123,,SAS,W 123-118,240,49,95,.516,38,68,.559,11,27,.407,14,18,.778,123,42,96,.438,27,58,.466,15,38,.395,19,23,.826,118
603,TOR,2024-02-23,123,@,ATL,W 123-121,240,50,102,.490,35,63,.556,15,39,.385,8,8,1.000,123,46,106,.434,34,67,.507,12,39,.308,17,24,.708,121
604,DAL,2024-02-22,123,,PHO,W 123-113,240,43,90,.478,24,46,.522,19,44,.432,18,21,.857,123,40,83,.482,25,47,.532,15,36,.417,18,24,.750,113
605,MIA,2024-02-13,123,@,MIL,W 123-97,240,45,87,.517,26,47,.553,19,40,.475,14,18,.778,123,37,83,.446,24,44,.545,13,39,.333,10,11,.909,97
606,PHI,2024-02-12,123,@,CLE,W 123-121,240,48,88,.545,37,62,.597,11,26,.423,16,19,.842,123,44,92,.478,31,55,.564,13,37,.351,20,25,.800,121
607,BRK,2024-02-10,123,,SAS,W 123-103,240,49,87,.563,32,53,.604,17,34,.500,8,11,.727,123,36,91,.396,25,57,.439,11,34,.324,20,21,.952,103
608,TOR,2024-02-07,123,@,CHO,W 123-117,240,43,81,.531,26,48,.542,17,33,.515,20,24,.833,123,44,90,.489,28,51,.549,16,39,.410,13,20,.650,117
609,NYK,2024-02-06,123,,MEM,W 123-113,240,48,86,.558,37,59,.627,11,27,.407,16,20,.800,123,41,80,.513,20,43,.465,21,37,.568,10,16,.625,113
610,MIN,2024-02-06,123,@,CHI,L 123-129 (OT),265,42,92,.457,22,47,.468,20,45,.444,19,26,.731,123,45,93,.484,33,63,.524,12,30,.400,27,32,.844,129
611,UTA,2024-02-04,123,,MIL,W 123-108,240,43,89,.483,26,45,.578,17,44,.386,20,24,.833,123,39,84,.464,24,43,.558,15,41,.366,15,25,.600,108
612,SAC,2024-02-03,123,@,CHI,W 123-115,240,42,84,.500,27,45,.600,15,39,.385,24,29,.828,123,42,91,.462,31,57,.544,11,34,.324,20,22,.909,115
613,UTA,2024-01-25,123,@,WAS,W 123-108,240,50,97,.515,37,66,.561,13,31,.419,10,12,.833,123,43,88,.489,36,58,.621,7,30,.233,15,20,.750,108
614,SAS,2024-01-22,123,@,PHI,L 123-133,240,43,93,.462,30,52,.577,13,41,.317,24,27,.889,123,48,97,.495,43,77,.558,5,20,.250,32,40,.800,133
615,PHO,2024-01-19,123,@,NOP,W 123-109,240,46,93,.495,31,52,.596,15,41,.366,16,21,.762,123,41,93,.441,31,51,.608,10,42,.238,17,23,.739,109
616,SAC,2024-01-10,123,@,CHO,W 123-98,240,46,89,.517,33,54,.611,13,35,.371,18,23,.783,123,35,87,.402,19,49,.388,16,38,.421,12,16,.750,98
617,BOS,2024-01-02,123,@,OKC,L 123-127,240,42,92,.457,27,52,.519,15,40,.375,24,29,.828,123,48,91,.527,30,51,.588,18,40,.450,13,17,.765,127
618,SAC,2023-12-31,123,@,MEM,W 123-92,240,47,92,.511,31,59,.525,16,33,.485,13,17,.765,123,30,82,.366,18,42,.429,12,40,.300,20,28,.714,92
619,IND,2023-12-26,123,@,HOU,W 123-117,240,43,82,.524,24,39,.615,19,43,.442,18,21,.857,123,47,97,.485,42,73,.575,5,24,.208,18,22,.818,117
620,NOP,2023-12-21,123,@,CLE,W 123-104,240,47,86,.547,32,51,.627,15,35,.429,14,16,.875,123,41,87,.471,24,43,.558,17,44,.386,5,8,.625,104
621,IND,2023-12-15,123,@,WAS,L 123-137,240,48,107,.449,33,67,.493,15,40,.375,12,16,.750,123,52,92,.565,39,65,.600,13,27,.481,20,26,.769,137
622,OKC,2023-12-14,123,@,SAC,L 123-128,240,44,102,.431,33,66,.500,11,36,.306,24,27,.889,123,47,95,.495,29,50,.580,18,45,.400,16,21,.762,128
623,DET,2023-12-11,123,,IND,L 123-131,240,45,81,.556,35,52,.673,10,29,.345,23,30,.767,123,52,92,.565,39,61,.639,13,31,.419,14,19,.737,131
624,NYK,2023-12-08,123,@,BOS,L 123-133,240,44,88,.500,29,51,.569,15,37,.405,20,27,.741,123,48,91,.527,29,44,.659,19,47,.404,18,21,.857,133
625,ORL,2023-12-08,123,,DET,W 123-91,240,49,89,.551,39,63,.619,10,26,.385,15,19,.789,123,34,81,.420,28,51,.549,6,30,.200,17,24,.708,91
626,SAC,2023-12-02,123,,DEN,W 123-117,240,48,99,.485,32,65,.492,16,34,.471,11,15,.733,123,49,99,.495,43,74,.581,6,25,.240,13,20,.650,117
627,MIN,2023-12-02,123,@,CHO,W 123-117,240,43,84,.512,32,53,.604,11,31,.355,26,30,.867,123,44,91,.484,32,66,.485,12,25,.480,17,19,.895,117
628,GSW,2023-11-28,123,@,SAC,L 123-124,240,40,83,.482,23,42,.548,17,41,.415,26,30,.867,123,41,91,.451,26,47,.553,15,44,.341,27,42,.643,124
629,OKC,2023-11-25,123,,PHI,L 123-127,240,43,98,.439,27,55,.491,16,43,.372,21,26,.808,123,38,83,.458,24,42,.571,14,41,.341,37,45,.822,127
630,PHO,2023-11-22,123,,GSW,W 123-115,240,34,76,.447,23,48,.479,11,28,.393,44,52,.846,123,43,90,.478,33,58,.569,10,32,.313,19,29,.655,115
631,GSW,2023-11-18,123,,OKC,L 123-130 (OT),265,44,97,.454,26,51,.510,18,46,.391,17,21,.810,123,52,100,.520,44,77,.571,8,23,.348,18,20,.900,130
632,OKC,2023-11-14,123,,SAS,W 123-87,240,46,89,.517,31,50,.620,15,39,.385,16,20,.800,123,36,93,.387,27,63,.429,9,30,.300,6,9,.667,87
633,TOR,2023-11-05,123,@,SAS,W 123-116 (OT),265,44,97,.454,25,49,.510,19,48,.396,16,26,.615,123,48,96,.500,38,64,.594,10,32,.313,10,13,.769,116
634,ATL,2023-11-04,123,@,NOP,W 123-105,240,45,93,.484,31,52,.596,14,41,.341,19,24,.792,123,40,84,.476,32,53,.604,8,31,.258,17,21,.810,105
635,DEN,2023-11-04,123,,CHI,W 123-101,240,42,81,.519,26,45,.578,16,36,.444,23,30,.767,123,39,86,.453,32,60,.533,7,26,.269,16,23,.696,101
636,MIN,2023-11-04,123,,UTA,W 123-95,240,45,81,.556,36,57,.632,9,24,.375,24,31,.774,123,35,91,.385,23,48,.479,12,43,.279,13,17,.765,95
637,LAC,2023-10-29,123,,SAS,W 123-83,240,47,91,.516,31,49,.633,16,42,.381,13,21,.619,123,30,80,.375,19,47,.404,11,33,.333,12,16,.750,83
638,LAC,2023-10-25,123,,POR,W 123-111,240,47,90,.522,31,56,.554,16,34,.471,13,16,.813,123,44,93,.473,34,61,.557,10,32,.313,13,17,.765,111
639,WAS,2024-04-14,122,@,BOS,L 122-132,240,49,103,.476,35,65,.538,14,38,.368,10,10,1.000,122,51,89,.573,35,57,.614,16,32,.500,14,21,.667,132
640,WAS,2024-04-07,122,@,TOR,L 122-130,240,42,89,.472,26,49,.531,16,40,.400,22,30,.733,122,49,96,.510,38,65,.585,11,31,.355,21,28,.750,130
641,NYK,2024-04-07,122,@,MIL,W 122-109,240,45,92,.489,31,63,.492,14,29,.483,18,22,.818,122,35,75,.467,23,41,.561,12,34,.353,27,32,.844,109
642,PHO,2024-04-03,122,,CLE,W 122-101,240,44,87,.506,26,54,.481,18,33,.545,16,17,.941,122,39,83,.470,32,57,.561,7,26,.269,16,19,.842,101
643,MIL,2024-03-30,122,@,ATL,W 122-113,240,43,78,.551,35,50,.700,8,28,.286,28,35,.800,122,42,92,.457,28,57,.491,14,35,.400,15,18,.833,113
644,BOS,2024-03-28,122,@,ATL,L 122-123 (OT),265,45,94,.479,31,58,.534,14,36,.389,18,21,.857,122,51,104,.490,36,60,.600,15,44,.341,6,10,.600,123
645,BRK,2024-03-27,122,@,WAS,W 122-119 (OT),265,47,98,.480,37,65,.569,10,33,.303,18,23,.783,122,46,91,.505,32,57,.561,14,34,.412,13,17,.765,119
646,BOS,2024-03-20,122,,MIL,W 122-119,240,40,85,.471,22,45,.489,18,40,.450,24,29,.828,122,45,84,.536,28,49,.571,17,35,.486,12,14,.857,119
647,IND,2024-03-20,122,@,DET,W 122-103,240,50,88,.568,39,59,.661,11,29,.379,11,18,.611,122,37,90,.411,32,67,.478,5,23,.217,24,30,.800,103
648,SAS,2024-03-17,122,,BRK,W 122-115 (OT),265,46,99,.465,37,62,.597,9,37,.243,21,23,.913,122,47,102,.461,39,71,.549,8,31,.258,13,19,.684,115
649,ATL,2024-03-15,122,@,UTA,L 122-124,240,41,92,.446,21,53,.396,20,39,.513,20,27,.741,122,46,90,.511,32,54,.593,14,36,.389,18,20,.900,124
650,MIL,2024-03-08,122,@,LAL,L 122-123,240,46,93,.495,30,52,.577,16,41,.390,14,17,.824,122,47,90,.522,31,56,.554,16,34,.471,13,19,.684,123
651,GSW,2024-03-07,122,,CHI,L 122-125,240,44,97,.454,33,55,.600,11,42,.262,23,28,.821,122,46,87,.529,30,51,.588,16,36,.444,17,23,.739,125
652,LAC,2024-03-06,122,@,HOU,W 122-116,240,44,80,.550,32,51,.627,12,29,.414,22,26,.846,122,45,94,.479,29,57,.509,16,37,.432,10,17,.588,116
653,POR,2024-03-01,122,@,MEM,W 122-92,240,48,92,.522,35,61,.574,13,31,.419,13,16,.813,122,35,79,.443,26,55,.473,9,24,.375,13,22,.591,92
654,IND,2024-02-26,122,,TOR,L 122-130,240,46,100,.460,33,58,.569,13,42,.310,17,23,.739,122,53,96,.552,41,68,.603,12,28,.429,12,17,.706,130
655,SAS,2024-02-22,122,@,SAC,L 122-127,240,50,98,.510,39,73,.534,11,25,.440,11,16,.688,122,52,93,.559,39,60,.650,13,33,.394,10,14,.714,127
656,CHO,2024-02-14,122,,ATL,W 122-99,240,44,89,.494,29,52,.558,15,37,.405,19,20,.950,122,36,89,.404,27,51,.529,9,38,.237,18,20,.900,99
657,UTA,2024-02-14,122,,LAL,L 122-138,240,49,101,.485,35,56,.625,14,45,.311,10,13,.769,122,52,91,.571,38,60,.633,14,31,.452,20,24,.833,138
658,SAS,2024-02-12,122,@,TOR,W 122-99,240,46,87,.529,35,57,.614,11,30,.367,19,23,.826,122,39,98,.398,31,67,.463,8,31,.258,13,16,.813,99
659,ATL,2024-02-10,122,,HOU,W 122-113,240,40,88,.455,26,47,.553,14,41,.341,28,37,.757,122,44,100,.440,31,57,.544,13,43,.302,12,19,.632,113
660,NOP,2024-02-09,122,@,LAL,L 122-139,240,46,89,.517,35,60,.583,11,29,.379,19,23,.826,122,49,88,.557,35,57,.614,14,31,.452,27,32,.844,139
661,DAL,2024-02-08,122,@,NYK,W 122-108,240,43,82,.524,25,40,.625,18,42,.429,18,23,.783,122,42,94,.447,28,57,.491,14,37,.378,10,11,.909,108
662,POR,2024-02-08,122,,DET,L 122-128 (OT),265,41,89,.461,30,59,.508,11,30,.367,29,33,.879,122,45,93,.484,29,66,.439,16,27,.593,22,31,.710,128
663,IND,2024-02-02,122,,SAC,L 122-133,240,46,85,.541,36,56,.643,10,29,.345,20,24,.833,122,51,90,.567,38,56,.679,13,34,.382,18,28,.643,133
664,LAL,2024-01-30,122,@,ATL,L 122-138,240,48,90,.533,36,57,.632,12,33,.364,14,25,.560,122,53,101,.525,37,63,.587,16,38,.421,16,18,.889,138
665,CHO,2024-01-27,122,,UTA,L 122-134,240,47,92,.511,34,60,.567,13,32,.406,15,21,.714,122,52,93,.559,35,52,.673,17,41,.415,13,17,.765,134
666,PHI,2024-01-25,122,@,IND,L 122-134,240,42,87,.483,35,58,.603,7,29,.241,31,43,.721,122,53,93,.570,41,65,.631,12,28,.429,16,21,.762,134
667,NYK,2024-01-25,122,,DEN,W 122-84,240,45,85,.529,30,47,.638,15,38,.395,17,20,.850,122,34,84,.405,29,58,.500,5,26,.192,11,13,.846,84
668,SAC,2024-01-22,122,,ATL,W 122-107,240,43,93,.462,31,55,.564,12,38,.316,24,27,.889,122,36,93,.387,22,53,.415,14,40,.350,21,27,.778,107
669,MIL,2024-01-22,122,@,DET,W 122-113,240,42,94,.447,32,55,.582,10,39,.256,28,34,.824,122,40,89,.449,30,59,.508,10,30,.333,23,29,.793,113
670,CHI,2024-01-13,122,@,SAS,W 122-116,240,46,90,.511,31,56,.554,15,34,.441,15,20,.750,122,39,95,.411,21,49,.429,18,46,.391,20,23,.870,116
671,MIN,2024-01-05,122,@,HOU,W 122-95,240,46,88,.523,32,55,.582,14,33,.424,16,20,.800,122,36,90,.400,24,58,.414,12,32,.375,11,15,.733,95
672,ORL,2024-01-05,122,@,DEN,W 122-120,240,41,82,.500,24,46,.522,17,36,.472,23,34,.676,122,48,95,.505,39,62,.629,9,33,.273,15,19,.789,120
673,PHO,2024-01-03,122,,LAC,L 122-131,240,42,79,.532,27,44,.614,15,35,.429,23,26,.885,122,42,76,.553,24,42,.571,18,34,.529,29,32,.906,131
674,IND,2024-01-01,122,@,MIL,W 122-113,240,43,97,.443,38,62,.613,5,35,.143,31,38,.816,122,41,93,.441,31,53,.585,10,40,.250,21,26,.808,113
675,GSW,2023-12-30,122,,DAL,L 122-132,240,47,103,.456,28,55,.509,19,48,.396,9,13,.692,122,49,88,.557,33,48,.688,16,40,.400,18,22,.818,132
676,DET,2023-12-28,122,@,BOS,L 122-128 (OT),265,48,101,.475,34,58,.586,14,43,.326,12,19,.632,122,48,99,.485,37,60,.617,11,39,.282,21,25,.840,128
677,BRK,2023-12-27,122,,MIL,L 122-144,240,45,101,.446,38,69,.551,7,32,.219,25,29,.862,122,52,89,.584,29,38,.763,23,51,.451,17,23,.739,144
678,MIL,2023-12-25,122,@,NYK,L 122-129,240,45,95,.474,32,53,.604,13,42,.310,19,24,.792,122,50,92,.543,42,66,.636,8,26,.308,21,26,.808,129
679,MIA,2023-12-22,122,,ATL,W 122-113,240,40,86,.465,23,47,.489,17,39,.436,25,30,.833,122,42,96,.438,23,42,.548,19,54,.352,10,14,.714,113
680,DEN,2023-12-22,122,@,BRK,W 122-117,240,45,87,.517,34,61,.557,11,26,.423,21,25,.840,122,43,89,.483,30,56,.536,13,33,.394,18,26,.692,117
681,HOU,2023-12-22,122,,DAL,W 122-96,240,46,95,.484,35,57,.614,11,38,.289,19,23,.826,122,35,101,.347,28,61,.459,7,40,.175,19,26,.731,96
682,NYK,2023-12-16,122,@,LAC,L 122-144,240,44,94,.468,33,59,.559,11,35,.314,23,26,.885,122,50,88,.568,34,55,.618,16,33,.485,28,34,.824,144
683,PHO,2023-12-15,122,,NYK,L 122-139,240,47,90,.522,36,62,.581,11,28,.393,17,21,.810,122,49,82,.598,32,53,.604,17,29,.586,24,28,.857,139
684,UTA,2023-12-14,122,@,POR,W 122-114,240,49,92,.533,38,59,.644,11,33,.333,13,14,.929,122,43,103,.417,27,58,.466,16,45,.356,12,18,.667,114
685,WAS,2023-12-13,122,,NOP,L 122-142,240,42,82,.512,23,38,.605,19,44,.432,19,24,.792,122,50,96,.521,34,62,.548,16,34,.471,26,30,.867,142
686,LAL,2023-12-13,122,@,SAS,W 122-119,240,49,91,.538,35,56,.625,14,35,.400,10,17,.588,122,45,96,.469,29,59,.492,16,37,.432,13,18,.722,119
687,ATL,2023-12-11,122,,DEN,L 122-129,240,44,96,.458,27,52,.519,17,44,.386,17,18,.944,122,47,88,.534,35,59,.593,12,29,.414,23,29,.793,129
688,NYK,2023-12-05,122,@,MIL,L 122-146,240,43,87,.494,36,64,.563,7,23,.304,29,33,.879,122,55,91,.604,32,53,.604,23,38,.605,13,19,.684,146
689,IND,2023-12-04,122,,BOS,W 122-112,240,43,94,.457,24,54,.444,19,40,.475,17,21,.810,122,46,97,.474,34,56,.607,12,41,.293,8,12,.667,112
690,CLE,2023-11-21,122,@,PHI,W 122-119 (OT),265,46,94,.489,37,69,.536,9,25,.360,21,25,.840,122,40,96,.417,29,61,.475,11,35,.314,28,34,.824,119
691,NYK,2023-11-18,122,@,CHO,W 122-108,240,46,91,.505,30,54,.556,16,37,.432,14,19,.737,122,40,82,.488,23,47,.489,17,35,.486,11,13,.846,108
692,MIA,2023-11-16,122,,BRK,W 122-115,240,42,81,.519,27,46,.587,15,35,.429,23,24,.958,122,40,85,.471,26,49,.531,14,36,.389,21,27,.778,115
693,LAL,2023-11-10,122,@,PHO,W 122-119,240,42,84,.500,30,57,.526,12,27,.444,26,34,.765,122,42,94,.447,27,57,.474,15,37,.405,20,27,.741,119
694,MIN,2023-11-08,122,,NOP,W 122-101,240,45,82,.549,30,45,.667,15,37,.405,17,24,.708,122,36,93,.387,28,65,.431,8,28,.286,21,22,.955,101
695,HOU,2023-11-06,122,,SAC,W 122-97,240,43,75,.573,28,44,.636,15,31,.484,21,27,.778,122,36,81,.444,22,41,.537,14,40,.350,11,20,.550,97
696,MIL,2023-10-30,122,,MIA,W 122-114,240,44,87,.506,32,50,.640,12,37,.324,22,30,.733,122,41,86,.477,28,52,.538,13,34,.382,19,20,.950,114
697,GSW,2023-10-27,122,@,SAC,W 122-114,240,48,87,.552,34,55,.618,14,32,.438,12,14,.857,122,41,94,.436,29,54,.537,12,40,.300,20,29,.690,114
698,HOU,2023-10-27,122,@,SAS,L 122-126 (OT),265,52,100,.520,44,68,.647,8,32,.250,10,20,.500,122,46,94,.489,33,52,.635,13,42,.310,21,28,.750,126
699,SAC,2024-04-14,121,,POR,W 121-82,240,43,87,.494,30,53,.566,13,34,.382,22,27,.815,121,31,98,.316,24,53,.453,7,45,.156,13,17,.765,82
700,SAS,2024-04-12,121,,DEN,W 121-120,240,45,85,.529,30,52,.577,15,33,.455,16,23,.696,121,49,97,.505,36,61,.590,13,36,.361,9,10,.900,120
701,HOU,2024-04-11,121,@,UTA,L 121-124,240,40,95,.421,19,48,.396,21,47,.447,20,22,.909,121,44,87,.506,30,48,.625,14,39,.359,22,27,.815,124
702,WAS,2024-04-09,121,@,MIN,L 121-130,240,44,89,.494,24,46,.522,20,43,.465,13,17,.765,121,43,90,.478,25,49,.510,18,41,.439,26,32,.813,130
703,OKC,2024-04-07,121,@,CHO,W 121-118,240,45,87,.517,27,51,.529,18,36,.500,13,17,.765,121,45,83,.542,28,43,.651,17,40,.425,11,14,.786,118
704,ATL,2024-04-03,121,,DET,W 121-113,240,49,90,.544,36,52,.692,13,38,.342,10,15,.667,121,43,94,.457,33,64,.516,10,30,.333,17,21,.810,113
705,PHI,2024-03-24,121,@,LAC,W 121-107,240,48,90,.533,30,53,.566,18,37,.486,7,9,.778,121,40,83,.482,30,55,.545,10,28,.357,17,18,.944,107
706,MIA,2024-03-24,121,,CLE,W 121-84,240,43,83,.518,28,45,.622,15,38,.395,20,23,.870,121,30,72,.417,21,43,.488,9,29,.310,15,20,.750,84
707,ORL,2024-03-21,121,,NOP,W 121-106,240,47,86,.547,33,50,.660,14,36,.389,13,19,.684,121,42,78,.538,36,58,.621,6,20,.300,16,21,.762,106
708,SAC,2024-03-18,121,,MEM,W 121-111 (OT),265,42,94,.447,31,59,.525,11,35,.314,26,32,.813,121,37,98,.378,24,60,.400,13,38,.342,24,30,.800,111
709,IND,2024-03-16,121,,BRK,W 121-100,240,50,105,.476,44,75,.587,6,30,.200,15,16,.938,121,33,77,.429,23,52,.442,10,25,.400,24,31,.774,100
710,LAL,2024-03-16,121,,GSW,L 121-128,240,47,92,.511,35,58,.603,12,34,.353,15,18,.833,121,51,97,.526,37,63,.587,14,34,.412,12,15,.800,128
711,IND,2024-03-12,121,@,OKC,W 121-111,240,48,89,.539,39,61,.639,9,28,.321,16,19,.842,121,43,99,.434,29,62,.468,14,37,.378,11,15,.733,111
712,BOS,2024-03-11,121,@,POR,W 121-99,240,49,100,.490,34,60,.567,15,40,.375,8,12,.667,121,39,87,.448,29,59,.492,10,28,.357,11,11,1.000,99
713,UTA,2024-03-09,121,@,DEN,L 121-142,240,47,94,.500,39,68,.574,8,26,.308,19,25,.760,121,55,83,.663,36,51,.706,19,32,.594,13,16,.813,142
714,PHI,2024-03-01,121,,CHO,W 121-114,240,46,96,.479,27,52,.519,19,44,.432,10,11,.909,121,43,84,.512,29,51,.569,14,33,.424,14,17,.824,114
715,CLE,2024-02-27,121,,DAL,W 121-119,240,44,83,.530,24,43,.558,20,40,.500,13,18,.722,121,48,91,.527,34,58,.586,14,33,.424,9,15,.600,119
716,MIA,2024-02-26,121,@,SAC,W 121-110,240,45,87,.517,34,57,.596,11,30,.367,20,25,.800,121,45,85,.529,32,53,.604,13,32,.406,7,12,.583,110
717,ATL,2024-02-23,121,,TOR,L 121-123,240,46,106,.434,34,67,.507,12,39,.308,17,24,.708,121,50,102,.490,35,63,.556,15,39,.385,8,8,1.000,123
718,TOR,2024-02-22,121,,BRK,W 121-93,240,41,84,.488,27,53,.509,14,31,.452,25,30,.833,121,33,80,.413,22,43,.512,11,37,.297,16,22,.727,93
719,MEM,2024-02-14,121,,HOU,W 121-113,240,39,79,.494,24,44,.545,15,35,.429,28,41,.683,121,42,102,.412,31,66,.470,11,36,.306,18,28,.643,113
720,MIN,2024-02-13,121,@,POR,W 121-109,240,39,84,.464,26,51,.510,13,33,.394,30,34,.882,121,39,87,.448,28,58,.483,11,29,.379,20,25,.800,109
721,CLE,2024-02-12,121,,PHI,L 121-123,240,44,92,.478,31,55,.564,13,37,.351,20,25,.800,121,48,88,.545,37,62,.597,11,26,.423,16,19,.842,123
722,MIN,2024-02-12,121,@,LAC,W 121-100,240,46,86,.535,35,52,.673,11,34,.324,18,19,.947,121,34,84,.405,25,56,.446,9,28,.321,23,26,.885,100
723,PHI,2024-02-09,121,,ATL,L 121-127,240,42,98,.429,27,53,.509,15,45,.333,22,29,.759,121,42,81,.519,26,45,.578,16,36,.444,27,33,.818,127
724,MIA,2024-02-06,121,,ORL,W 121-95,240,47,87,.540,34,51,.667,13,36,.361,14,18,.778,121,35,80,.438,25,45,.556,10,35,.286,15,21,.714,95
725,PHI,2024-02-03,121,,BRK,L 121-136,240,44,96,.458,32,67,.478,12,29,.414,21,27,.778,121,49,95,.516,29,44,.659,20,51,.392,18,23,.783,136
726,GSW,2024-02-02,121,@,MEM,W 121-101,240,46,83,.554,35,54,.648,11,29,.379,18,22,.818,121,35,87,.402,21,41,.512,14,46,.304,17,24,.708,101
727,MIN,2024-01-31,121,,DAL,W 121-87,240,45,80,.563,32,50,.640,13,30,.433,18,30,.600,121,31,76,.408,25,47,.532,6,29,.207,19,26,.731,87
728,DET,2024-01-31,121,@,CLE,L 121-128,240,45,81,.556,29,50,.580,16,31,.516,15,19,.789,121,47,89,.528,35,54,.648,12,35,.343,22,23,.957,128
729,SAC,2024-01-18,121,,IND,L 121-126,240,44,85,.518,29,48,.604,15,37,.405,18,32,.563,121,49,89,.551,36,56,.643,13,33,.394,15,19,.789,126
730,TOR,2024-01-17,121,,MIA,W 121-97,240,45,88,.511,25,50,.500,20,38,.526,11,18,.611,121,41,90,.456,35,62,.565,6,28,.214,9,12,.750,97
731,DEN,2024-01-16,121,@,PHI,L 121-126,240,45,89,.506,33,60,.550,12,29,.414,19,25,.760,121,43,76,.566,28,45,.622,15,31,.484,25,34,.735,126
732,MEM,2024-01-07,121,@,PHO,W 121-115,240,43,97,.443,26,48,.542,17,49,.347,18,24,.750,121,46,102,.451,38,74,.514,8,28,.286,15,22,.682,115
733,NYK,2024-01-06,121,@,WAS,W 121-105,240,43,87,.494,29,51,.569,14,36,.389,21,24,.875,121,40,85,.471,27,48,.563,13,37,.351,12,20,.600,105
734,SAS,2024-01-04,121,,MIL,L 121-125,240,46,95,.484,32,55,.582,14,40,.350,15,17,.882,121,49,92,.533,37,58,.638,12,34,.353,15,19,.789,125
735,GSW,2024-01-02,121,,ORL,W 121-115,240,42,78,.538,29,43,.674,13,35,.371,24,37,.649,121,41,92,.446,27,56,.482,14,36,.389,19,23,.826,115
736,LAC,2024-01-01,121,,MIA,W 121-104,240,47,80,.588,33,51,.647,14,29,.483,13,14,.929,121,35,83,.422,24,49,.490,11,34,.324,23,29,.793,104
737,CLE,2024-01-01,121,@,TOR,L 121-124,240,43,89,.483,31,53,.585,12,36,.333,23,26,.885,121,42,87,.483,31,57,.544,11,30,.367,29,40,.725,124
738,PHI,2023-12-22,121,,TOR,W 121-111,240,44,83,.530,30,52,.577,14,31,.452,19,21,.905,121,39,87,.448,30,54,.556,9,33,.273,24,28,.857,111
739,NYK,2023-12-20,121,@,BRK,W 121-102,240,44,95,.463,31,62,.500,13,33,.394,20,25,.800,121,37,101,.366,22,54,.407,15,47,.319,13,17,.765,102
740,LAC,2023-12-14,121,,GSW,W 121-113,240,41,81,.506,28,49,.571,13,32,.406,26,30,.867,121,40,92,.435,24,47,.511,16,45,.356,17,19,.895,113
741,NOP,2023-12-11,121,,MIN,W 121-107,240,40,82,.488,30,55,.545,10,27,.370,31,40,.775,121,40,91,.440,27,55,.491,13,36,.361,14,19,.737,107
742,CHI,2023-12-08,121,@,SAS,W 121-112,240,47,102,.461,34,74,.459,13,28,.464,14,24,.583,121,39,83,.470,22,41,.537,17,42,.405,17,20,.850,112
743,CLE,2023-12-06,121,,ORL,W 121-111,240,46,86,.535,32,52,.615,14,34,.412,15,20,.750,121,41,84,.488,39,61,.639,2,23,.087,27,37,.730,111
744,ATL,2023-12-02,121,@,MIL,L 121-132,240,45,101,.446,30,63,.476,15,38,.395,16,21,.762,121,53,89,.596,39,56,.696,14,33,.424,12,15,.800,132
745,NOP,2023-12-01,121,,SAS,W 121-106,240,42,85,.494,32,54,.593,10,31,.323,27,29,.931,121,38,83,.458,22,44,.500,16,39,.410,14,17,.824,106
746,DAL,2023-11-28,121,,HOU,W 121-115,240,42,89,.472,30,55,.545,12,34,.353,25,29,.862,121,42,85,.494,34,56,.607,8,29,.276,23,29,.793,115
747,LAL,2023-11-25,121,@,CLE,W 121-115,240,47,90,.522,38,63,.603,9,27,.333,18,21,.857,121,43,91,.473,34,63,.540,9,28,.321,20,23,.870,115
748,TOR,2023-11-24,121,,CHI,W 121-108,240,44,83,.530,31,44,.705,13,39,.333,20,27,.741,121,42,82,.512,30,55,.545,12,27,.444,12,19,.632,108
749,POR,2023-11-22,121,,UTA,W 121-105,240,47,92,.511,30,53,.566,17,39,.436,10,15,.667,121,37,79,.468,27,48,.563,10,31,.323,21,26,.808,105
750,GSW,2023-11-20,121,,HOU,W 121-116,240,36,77,.468,15,34,.441,21,43,.488,28,33,.848,121,44,95,.463,31,54,.574,13,41,.317,15,19,.789,116
751,CHO,2023-11-20,121,,BOS,W 121-118 (OT),265,46,104,.442,33,65,.508,13,39,.333,16,17,.941,121,42,97,.433,26,47,.553,16,50,.320,18,28,.643,118
752,PHI,2023-11-19,121,@,BRK,W 121-99,240,44,94,.468,28,59,.475,16,35,.457,17,18,.944,121,38,81,.469,27,53,.509,11,28,.393,12,16,.750,99
753,CLE,2023-11-19,121,,DEN,W 121-109,240,45,82,.549,34,55,.618,11,27,.407,20,26,.769,121,39,82,.476,25,53,.472,14,29,.483,17,23,.739,109
754,MIN,2023-11-18,121,@,NOP,W 121-120,240,43,80,.538,30,49,.612,13,31,.419,22,27,.815,121,44,86,.512,32,57,.561,12,29,.414,20,23,.870,120
755,BOS,2023-11-10,121,,BRK,W 121-107,240,41,94,.436,22,42,.524,19,52,.365,20,28,.714,121,38,85,.447,23,48,.479,15,37,.405,16,18,.889,107
756,MEM,2023-11-10,121,,UTA,L 121-127,240,46,101,.455,27,53,.509,19,48,.396,10,13,.769,121,41,76,.539,23,39,.590,18,37,.486,27,29,.931,127
757,SAC,2023-11-08,121,,POR,W 121-118 (OT),265,41,89,.461,30,52,.577,11,37,.297,28,38,.737,121,44,87,.506,36,65,.554,8,22,.364,22,29,.759,118
758,IND,2023-11-03,121,,CLE,W 121-116,240,45,86,.523,30,55,.545,15,31,.484,16,24,.667,121,44,84,.524,36,56,.643,8,28,.286,20,25,.800,116
759,MIA,2023-11-03,121,,WAS,W 121-114,240,48,80,.600,35,53,.660,13,27,.481,12,14,.857,121,46,81,.568,33,53,.623,13,28,.464,9,17,.529,114
760,PHO,2023-11-02,121,,SAS,L 121-132,240,43,80,.538,27,48,.563,16,32,.500,19,26,.731,121,51,98,.520,33,61,.541,18,37,.486,12,13,.923,132
761,WAS,2023-11-01,121,@,ATL,L 121-130,240,51,101,.505,41,61,.672,10,40,.250,9,14,.643,121,46,92,.500,37,60,.617,9,32,.281,29,32,.906,130
762,CHO,2023-10-30,121,,BRK,L 121-133,240,47,96,.490,39,65,.600,8,31,.258,19,20,.950,121,49,87,.563,37,54,.685,12,33,.364,23,32,.719,133
763,CHO,2024-04-14,120,@,CLE,W 120-110,240,46,91,.505,27,51,.529,19,40,.475,9,11,.818,120,44,93,.473,28,60,.467,16,33,.485,6,9,.667,110
764,NYK,2024-04-14,120,,CHI,W 120-119 (OT),265,46,91,.505,34,59,.576,12,32,.375,16,21,.762,120,49,101,.485,41,70,.586,8,31,.258,13,16,.813,119
765,IND,2024-04-12,120,@,CLE,L 120-129,240,46,89,.517,37,57,.649,9,32,.281,19,22,.864,120,50,95,.526,37,63,.587,13,32,.406,16,23,.696,129
766,DEN,2024-04-12,120,@,SAS,L 120-121,240,49,97,.505,36,61,.590,13,36,.361,9,10,.900,120,45,85,.529,30,52,.577,15,33,.455,16,23,.696,121
767,MEM,2024-04-12,120,,LAL,L 120-123,240,43,95,.453,26,56,.464,17,39,.436,17,21,.810,120,42,81,.519,29,44,.659,13,37,.351,26,34,.765,123
768,PHI,2024-04-09,120,,DET,W 120-102,240,44,98,.449,31,61,.508,13,37,.351,19,23,.826,120,34,84,.405,20,54,.370,14,30,.467,20,24,.833,102
769,LAL,2024-04-09,120,,GSW,L 120-134,240,44,96,.458,32,61,.525,12,35,.343,20,24,.833,120,47,80,.588,21,39,.538,26,41,.634,14,21,.667,134
770,LAC,2024-04-07,120,,CLE,W 120-118,240,41,84,.488,27,49,.551,14,35,.400,24,24,1.000,120,42,88,.477,31,58,.534,11,30,.367,23,27,.852,118
771,NYK,2024-04-04,120,,SAC,W 120-109,240,44,80,.550,32,52,.615,12,28,.429,20,29,.690,120,42,86,.488,24,44,.545,18,42,.429,7,12,.583,109
772,WAS,2024-04-03,120,,LAL,L 120-125,240,45,91,.495,27,49,.551,18,42,.429,12,13,.923,120,46,91,.505,38,63,.603,8,28,.286,25,29,.862,125
773,TOR,2024-03-31,120,,PHI,L 120-135,240,47,90,.522,36,60,.600,11,30,.367,15,20,.750,120,49,83,.590,25,40,.625,24,43,.558,13,16,.813,135
774,ATL,2024-03-27,120,,POR,W 120-106,240,44,85,.518,28,44,.636,16,41,.390,16,20,.800,120,43,85,.506,29,54,.537,14,31,.452,6,10,.600,106
775,ATL,2024-03-25,120,,BOS,W 120-118,240,46,87,.529,28,51,.549,18,36,.500,10,17,.588,120,47,95,.495,36,57,.632,11,38,.289,13,19,.684,118
776,SAC,2024-03-13,120,,LAL,W 120-107,240,46,88,.523,27,47,.574,19,41,.463,9,12,.750,120,38,78,.487,24,46,.522,14,32,.438,17,22,.773,107
777,BRK,2024-03-10,120,@,CLE,W 120-101,240,42,79,.532,24,44,.545,18,35,.514,18,20,.900,120,37,76,.487,23,44,.523,14,32,.438,13,20,.650,101
778,LAL,2024-03-10,120,,MIN,W 120-109,240,44,83,.530,34,59,.576,10,24,.417,22,29,.759,120,41,97,.423,25,51,.490,16,46,.348,11,13,.846,109
779,PHO,2024-03-07,120,,TOR,W 120-113,240,44,86,.512,29,51,.569,15,35,.429,17,20,.850,120,43,94,.457,27,50,.540,16,44,.364,11,15,.733,113
780,LAL,2024-03-06,120,,SAC,L 120-130,240,42,81,.519,27,49,.551,15,32,.469,21,25,.840,120,54,97,.557,42,66,.636,12,31,.387,10,12,.833,130
781,POR,2024-03-06,120,,OKC,L 120-128,240,41,81,.506,27,47,.574,14,34,.412,24,27,.889,120,43,74,.581,34,52,.654,9,22,.409,33,39,.846,128
782,DAL,2024-03-05,120,,IND,L 120-137,240,45,93,.484,32,54,.593,13,39,.333,17,21,.810,120,50,93,.538,32,54,.593,18,39,.462,19,24,.792,137
783,PHI,2024-03-03,120,@,DAL,W 120-116,240,40,88,.455,29,51,.569,11,37,.297,29,31,.935,120,40,86,.465,24,45,.533,16,41,.390,20,23,.870,116
784,UTA,2024-03-02,120,@,MIA,L 120-126,240,42,87,.483,28,52,.538,14,35,.400,22,26,.846,120,46,88,.523,33,54,.611,13,34,.382,21,25,.840,126
785,GSW,2024-03-01,120,@,TOR,W 120-105,240,44,98,.449,26,54,.481,18,44,.409,14,18,.778,120,41,95,.432,29,50,.580,12,45,.267,11,17,.647,105
786,MIN,2024-03-01,120,,SAC,L 120-124 (OT),265,42,85,.494,30,54,.556,12,31,.387,24,32,.750,120,50,100,.500,39,71,.549,11,29,.379,13,24,.542,124
787,MIL,2024-02-09,120,,CHO,W 120-84,240,41,94,.436,23,42,.548,18,52,.346,20,24,.833,120,27,79,.342,20,50,.400,7,29,.241,23,29,.793,84
788,SAC,2024-02-07,120,,DET,L 120-133,240,45,95,.474,30,51,.588,15,44,.341,15,22,.682,120,47,84,.560,30,53,.566,17,31,.548,22,22,1.000,133
789,PHO,2024-02-02,120,@,ATL,L 120-129,240,47,88,.534,33,51,.647,14,37,.378,12,14,.857,120,49,95,.516,32,51,.627,17,44,.386,14,18,.778,129
790,DEN,2024-02-02,120,,POR,W 120-108,240,46,91,.505,34,55,.618,12,36,.333,16,17,.941,120,37,80,.463,27,52,.519,10,28,.357,24,30,.800,108
791,BRK,2024-01-31,120,,PHO,L 120-136,240,47,94,.500,31,55,.564,16,39,.410,10,13,.769,120,49,79,.620,35,51,.686,14,28,.500,24,32,.750,136
792,DET,2024-01-28,120,,OKC,W 120-104,240,47,95,.495,36,69,.522,11,26,.423,15,19,.789,120,44,92,.478,36,64,.563,8,28,.286,8,12,.667,104
793,SAC,2024-01-27,120,@,DAL,W 120-115,240,43,80,.538,32,50,.640,11,30,.367,23,30,.767,120,43,98,.439,27,52,.519,16,46,.348,13,18,.722,115
794,SAS,2024-01-19,120,@,CHO,L 120-124,240,47,84,.560,32,52,.615,15,32,.469,11,17,.647,120,47,84,.560,31,55,.564,16,29,.552,14,16,.875,124
795,NOP,2024-01-15,120,@,DAL,L 120-125,240,41,81,.506,34,58,.586,7,23,.304,31,41,.756,120,39,85,.459,21,42,.500,18,43,.419,29,35,.829,125
796,MIN,2024-01-10,120,@,BOS,L 120-127 (OT),265,44,95,.463,30,61,.492,14,34,.412,18,20,.900,120,39,90,.433,20,43,.465,19,47,.404,30,31,.968,127
797,MIA,2024-01-10,120,,OKC,L 120-128,240,41,89,.461,26,53,.491,15,36,.417,23,28,.821,120,51,86,.593,37,53,.698,14,33,.424,12,16,.750,128
798,TOR,2024-01-10,120,@,LAC,L 120-126,240,46,84,.548,34,54,.630,12,30,.400,16,18,.889,120,49,93,.527,34,59,.576,15,34,.441,13,13,1.000,126
799,MEM,2024-01-09,120,@,DAL,W 120-103,240,44,91,.484,30,54,.556,14,37,.378,18,21,.857,120,36,82,.439,27,55,.491,9,27,.333,22,27,.815,103
800,MIA,2024-01-08,120,,HOU,W 120-113,240,41,82,.500,26,46,.565,15,36,.417,23,32,.719,120,37,88,.420,23,47,.489,14,41,.341,25,28,.893,113
801,UTA,2024-01-06,120,@,PHI,W 120-109,240,46,80,.575,38,50,.760,8,30,.267,20,24,.833,120,42,104,.404,35,66,.530,7,38,.184,18,23,.783,109
802,DEN,2024-01-05,120,,ORL,L 120-122,240,48,95,.505,39,62,.629,9,33,.273,15,19,.789,120,41,82,.500,24,46,.522,17,36,.472,23,34,.676,122
803,BOS,2023-12-29,120,,TOR,W 120-118,240,43,88,.489,26,49,.531,17,39,.436,17,20,.850,120,44,95,.463,27,51,.529,17,44,.386,13,20,.650,118
804,IND,2023-12-28,120,@,CHI,W 120-104,240,43,85,.506,24,43,.558,19,42,.452,15,22,.682,120,40,97,.412,33,70,.471,7,27,.259,17,22,.773,104
805,NYK,2023-12-27,120,@,OKC,L 120-129,240,41,82,.500,27,48,.563,14,34,.412,24,30,.800,120,49,90,.544,35,58,.603,14,32,.438,17,22,.773,129
806,DEN,2023-12-25,120,,GSW,W 120-114,240,40,82,.488,26,48,.542,14,34,.412,26,32,.813,120,40,87,.460,26,47,.553,14,40,.350,20,23,.870,114
807,OKC,2023-12-23,120,,LAL,L 120-129,240,46,95,.484,33,54,.611,13,41,.317,15,19,.789,120,47,90,.522,31,58,.534,16,32,.500,19,23,.826,129
808,SAC,2023-12-22,120,,PHO,W 120-105,240,44,83,.530,32,45,.711,12,38,.316,20,26,.769,120,39,88,.443,34,63,.540,5,25,.200,22,28,.786,105
809,LAC,2023-12-20,120,@,DAL,W 120-111,240,43,77,.558,32,46,.696,11,31,.355,23,25,.920,120,39,91,.429,25,48,.521,14,43,.326,19,27,.704,111
810,POR,2023-12-16,120,,DAL,L 120-131,240,47,94,.500,40,62,.645,7,32,.219,19,22,.864,120,48,97,.495,32,50,.640,16,47,.340,19,21,.905,131
811,BRK,2023-12-16,120,@,GSW,L 120-124,240,45,93,.484,28,50,.560,17,43,.395,13,15,.867,120,44,91,.484,27,59,.458,17,32,.531,19,20,.950,124
812,BOS,2023-12-12,120,,CLE,W 120-113,240,38,84,.452,20,40,.500,18,44,.409,26,26,1.000,120,44,92,.478,25,47,.532,19,45,.422,6,9,.667,113
813,DAL,2023-12-11,120,@,MEM,W 120-113,240,43,86,.500,26,46,.565,17,40,.425,17,19,.895,120,41,89,.461,23,45,.511,18,44,.409,13,16,.813,113
814,UTA,2023-12-11,120,@,OKC,L 120-134,240,44,92,.478,32,54,.593,12,38,.316,20,21,.952,120,50,96,.521,32,58,.552,18,38,.474,16,17,.941,134
815,DAL,2023-12-02,120,,OKC,L 120-126,240,39,87,.448,20,35,.571,19,52,.365,23,35,.657,120,44,100,.440,24,56,.429,20,44,.455,18,22,.818,126
816,GSW,2023-11-30,120,,LAC,W 120-114,240,41,82,.500,26,43,.605,15,39,.385,23,31,.742,120,42,95,.442,30,63,.476,12,32,.375,18,24,.750,114
817,CHI,2023-11-30,120,,MIL,W 120-113 (OT),265,45,98,.459,32,61,.525,13,37,.351,17,22,.773,120,44,98,.449,28,50,.560,16,48,.333,9,13,.692,113
818,WAS,2023-11-29,120,@,ORL,L 120-139,240,41,87,.471,30,58,.517,11,29,.379,27,35,.771,120,51,84,.607,34,57,.596,17,27,.630,20,24,.833,139
819,SAS,2023-11-26,120,@,DEN,L 120-132,240,42,93,.452,28,56,.500,14,37,.378,22,26,.846,120,50,89,.562,38,61,.623,12,28,.429,20,25,.800,132
820,PHO,2023-11-21,120,,POR,W 120-107,240,43,76,.566,36,59,.610,7,17,.412,27,28,.964,120,38,87,.437,24,56,.429,14,31,.452,17,20,.850,107
821,MEM,2023-11-18,120,@,SAS,W 120-108,240,40,86,.465,29,53,.547,11,33,.333,29,36,.806,120,36,83,.434,21,43,.488,15,40,.375,21,26,.808,108
822,NOP,2023-11-18,120,,MIN,L 120-121,240,44,86,.512,32,57,.561,12,29,.414,20,23,.870,120,43,80,.538,30,49,.612,13,31,.419,22,27,.815,121
823,SAS,2023-11-17,120,,SAC,L 120-129,240,43,92,.467,28,56,.500,15,36,.417,19,23,.826,120,46,85,.541,28,43,.651,18,42,.429,19,24,.792,129
824,NYK,2023-11-17,120,@,WAS,W 120-99,240,45,91,.495,29,53,.547,16,38,.421,14,20,.700,120,37,82,.451,27,50,.540,10,32,.313,15,16,.938,99
825,DET,2023-11-14,120,,ATL,L 120-126,240,47,90,.522,37,61,.607,10,29,.345,16,23,.696,120,45,87,.517,33,54,.611,12,33,.364,24,26,.923,126
826,CLE,2023-11-13,120,@,SAC,L 120-132,240,45,91,.495,29,56,.518,16,35,.457,14,17,.824,120,49,83,.590,29,41,.707,20,42,.476,14,22,.636,132
827,ATL,2023-11-09,120,@,ORL,W 120-119,240,41,85,.482,26,46,.565,15,39,.385,23,30,.767,120,42,90,.467,32,63,.508,10,27,.370,25,35,.714,119
828,CLE,2023-11-08,120,@,OKC,L 120-128,240,42,83,.506,33,54,.611,9,29,.310,27,37,.730,120,44,86,.512,32,58,.552,12,28,.429,28,30,.933,128
829,MIL,2023-11-08,120,,DET,W 120-118,240,41,90,.456,30,53,.566,11,37,.297,27,32,.844,120,48,98,.490,41,69,.594,7,29,.241,15,16,.938,118
830,GSW,2023-11-06,120,@,DET,W 120-109,240,46,97,.474,34,56,.607,12,41,.293,16,21,.762,120,38,80,.475,25,50,.500,13,30,.433,20,21,.952,109
831,PHO,2023-11-05,120,@,DET,W 120-106,240,43,86,.500,35,65,.538,8,21,.381,26,29,.897,120,43,87,.494,35,64,.547,8,23,.348,12,14,.857,106
832,ORL,2023-11-04,120,,LAL,W 120-101,240,46,101,.455,34,68,.500,12,33,.364,16,19,.842,120,37,84,.440,29,54,.537,8,30,.267,19,21,.905,101
833,ATL,2023-10-27,120,,NYK,L 120-126,240,42,87,.483,30,55,.545,12,32,.375,24,30,.800,120,43,90,.478,23,46,.500,20,44,.455,20,28,.714,126
834,BRK,2023-10-27,120,@,DAL,L 120-125,240,45,92,.489,24,49,.490,21,43,.488,9,10,.900,120,44,91,.484,29,55,.527,15,36,.417,22,28,.786,125
835,UTA,2023-10-27,120,,LAC,W 120-118,240,42,96,.438,26,55,.473,16,41,.390,20,22,.909,120,41,77,.532,27,42,.643,14,35,.400,22,28,.786,118
836,WAS,2023-10-25,120,@,IND,L 120-143,240,44,96,.458,35,72,.486,9,24,.375,23,29,.793,120,56,107,.523,36,64,.563,20,43,.465,11,12,.917,143
837,CHI,2024-04-14,119,@,NYK,L 119-120 (OT),265,49,101,.485,41,70,.586,8,31,.258,13,16,.813,119,46,91,.505,34,59,.576,12,32,.375,16,21,.762,120
838,MIA,2024-04-05,119,@,HOU,W 119-104,240,44,89,.494,31,53,.585,13,36,.361,18,21,.857,119,34,90,.378,20,46,.435,14,44,.318,22,25,.880,104
839,MIA,2024-03-31,119,@,WAS,W 119-107,240,40,81,.494,26,45,.578,14,36,.389,25,29,.862,119,40,88,.455,29,50,.580,11,38,.289,16,21,.762,107
840,WAS,2024-03-27,119,,BRK,L 119-122 (OT),265,46,91,.505,32,57,.561,14,34,.412,13,17,.765,119,47,98,.480,37,65,.569,10,33,.303,18,23,.783,122
841,OKC,2024-03-26,119,@,NOP,W 119-112,240,46,86,.535,31,52,.596,15,34,.441,12,14,.857,119,39,86,.453,25,48,.521,14,38,.368,20,23,.870,112
842,UTA,2024-03-23,119,@,HOU,L 119-147,240,40,89,.449,29,52,.558,11,37,.297,28,33,.848,119,54,97,.557,27,48,.563,27,49,.551,12,14,.857,147
843,OKC,2024-03-20,119,,UTA,W 119-107,240,43,88,.489,33,54,.611,10,34,.294,23,29,.793,119,40,90,.444,30,54,.556,10,36,.278,17,18,.944,107
844,MIL,2024-03-20,119,@,BOS,L 119-122,240,45,84,.536,28,49,.571,17,35,.486,12,14,.857,119,40,85,.471,22,45,.489,18,40,.450,24,29,.828,122
845,BOS,2024-03-18,119,,DET,W 119-94,240,43,95,.453,21,46,.457,22,49,.449,11,13,.846,119,36,84,.429,27,55,.491,9,29,.310,13,15,.867,94
846,NYK,2024-03-18,119,@,GSW,W 119-112,240,44,91,.484,30,54,.556,14,37,.378,17,20,.850,119,42,88,.477,28,52,.538,14,36,.389,14,18,.778,112
847,MIN,2024-03-16,119,@,UTA,W 119-100,240,44,93,.473,25,52,.481,19,41,.463,12,15,.800,119,38,83,.458,32,57,.561,6,26,.231,18,21,.857,100
848,DAL,2024-03-14,119,@,OKC,L 119-126,240,43,84,.512,31,55,.564,12,29,.414,21,26,.808,119,45,86,.523,29,47,.617,16,39,.410,20,23,.870,126
849,WAS,2024-03-14,119,@,HOU,L 119-135,240,46,93,.495,34,55,.618,12,38,.316,15,19,.789,119,51,87,.586,39,59,.661,12,28,.429,21,24,.875,135
850,TOR,2024-03-11,119,@,DEN,L 119-125,240,47,93,.505,36,63,.571,11,30,.367,14,17,.824,119,52,95,.547,42,66,.636,10,29,.345,11,18,.611,125
851,ORL,2024-03-06,119,@,WAS,W 119-109,240,44,81,.543,32,55,.582,12,26,.462,19,21,.905,119,40,88,.455,28,50,.560,12,38,.316,17,20,.850,109
852,CHI,2024-03-06,119,@,UTA,W 119-117,240,45,90,.500,28,51,.549,17,39,.436,12,15,.800,119,44,96,.458,29,49,.592,15,47,.319,14,16,.875,117
853,MIN,2024-03-04,119,,POR,W 119-114,240,40,79,.506,29,51,.569,11,28,.393,28,37,.757,119,45,92,.489,29,53,.547,16,39,.410,8,11,.727,114
854,DAL,2024-02-27,119,@,CLE,L 119-121,240,48,91,.527,34,58,.586,14,33,.424,9,15,.600,119,44,83,.530,24,43,.558,20,40,.500,13,18,.722,121
855,DEN,2024-02-25,119,@,GSW,W 119-103,240,43,88,.489,32,56,.571,11,32,.344,22,26,.846,119,35,81,.432,24,47,.511,11,34,.324,22,29,.759,103
856,MIL,2024-02-25,119,@,PHI,W 119-98,240,43,79,.544,25,42,.595,18,37,.486,15,18,.833,119,36,97,.371,20,51,.392,16,46,.348,10,11,.909,98
857,PHI,2024-02-10,119,@,WAS,W 119-113,240,48,100,.480,40,73,.548,8,27,.296,15,23,.652,119,42,86,.488,29,51,.569,13,35,.371,16,21,.762,113
858,CLE,2024-02-10,119,@,TOR,W 119-95,240,48,92,.522,34,51,.667,14,41,.341,9,13,.692,119,35,87,.402,26,56,.464,9,31,.290,16,23,.696,95
859,DAL,2024-02-06,119,@,BRK,W 119-107,240,46,91,.505,27,48,.563,19,43,.442,8,13,.615,119,41,91,.451,29,58,.500,12,33,.364,13,15,.867,107
860,POR,2024-01-31,119,,MIL,W 119-116,240,49,92,.533,37,64,.578,12,28,.429,9,9,1.000,119,45,92,.489,32,47,.681,13,45,.289,13,18,.722,116
861,GSW,2024-01-30,119,,PHI,W 119-107,240,44,79,.557,30,47,.638,14,32,.438,17,19,.895,119,39,85,.459,26,55,.473,13,30,.433,16,21,.762,107
862,LAL,2024-01-29,119,@,HOU,L 119-135,240,45,91,.495,32,56,.571,13,35,.371,16,26,.615,119,52,98,.531,40,62,.645,12,36,.333,19,25,.760,135
863,BOS,2024-01-22,119,@,DAL,W 119-110,240,41,88,.466,26,42,.619,15,46,.326,22,30,.733,119,43,97,.443,29,57,.509,14,40,.350,10,14,.714,110
864,PHO,2024-01-16,119,,SAC,W 119-117,240,42,85,.494,25,48,.521,17,37,.459,18,20,.900,119,46,92,.500,28,52,.538,18,40,.450,7,12,.583,117
865,MEM,2024-01-12,119,,LAC,L 119-128,240,41,95,.432,23,51,.451,18,44,.409,19,27,.704,119,49,89,.551,34,58,.586,15,31,.484,15,20,.750,128
866,HOU,2024-01-10,119,@,CHI,L 119-124 (OT),265,48,101,.475,37,56,.661,11,45,.244,12,20,.600,119,42,95,.442,23,48,.479,19,47,.404,21,25,.840,124
867,CHI,2024-01-08,119,@,CHO,W 119-112 (OT),265,45,92,.489,36,66,.545,9,26,.346,20,24,.833,119,40,94,.426,23,52,.442,17,42,.405,15,17,.882,112
868,OKC,2023-12-29,119,@,DEN,W 119-93,240,46,91,.505,34,56,.607,12,35,.343,15,16,.938,119,36,85,.424,26,48,.542,10,37,.270,11,15,.733,93
869,MIL,2023-12-29,119,@,CLE,W 119-111,240,41,80,.513,29,51,.569,12,29,.414,25,28,.893,119,49,103,.476,43,60,.717,6,43,.140,7,9,.778,111
870,CHO,2023-12-29,119,@,PHO,L 119-133,240,44,92,.478,21,46,.457,23,46,.500,8,8,1.000,119,46,74,.622,28,44,.636,18,30,.600,23,24,.958,133
871,WAS,2023-12-26,119,,ORL,L 119-127,240,43,87,.494,27,45,.600,16,42,.381,17,21,.810,119,49,93,.527,37,67,.552,12,26,.462,17,25,.680,127
872,MIA,2023-12-25,119,,PHI,W 119-113,240,40,84,.476,28,52,.538,12,32,.375,27,35,.771,119,40,94,.426,23,49,.469,17,45,.378,16,25,.640,113
873,ATL,2023-12-23,119,,MEM,L 119-125,240,45,96,.469,32,53,.604,13,43,.302,16,20,.800,119,50,97,.515,39,64,.609,11,33,.333,14,22,.636,125
874,TOR,2023-12-23,119,,UTA,L 119-126,240,45,94,.479,32,62,.516,13,32,.406,16,19,.842,119,48,91,.527,31,53,.585,17,38,.447,13,14,.929,126
875,SAS,2023-12-23,119,@,DAL,L 119-144,240,44,98,.449,30,53,.566,14,45,.311,17,24,.708,119,52,100,.520,29,55,.527,23,45,.511,17,21,.810,144
876,UTA,2023-12-21,119,@,DET,W 119-111,240,43,94,.457,32,64,.500,11,30,.367,22,24,.917,119,43,86,.500,34,55,.618,9,31,.290,16,19,.842,111
877,SAC,2023-12-20,119,,BOS,L 119-144,240,43,91,.473,22,47,.468,21,44,.477,12,23,.522,119,51,92,.554,29,50,.580,22,42,.524,20,24,.833,144
878,SAS,2023-12-19,119,@,MIL,L 119-132,240,46,96,.479,37,66,.561,9,30,.300,18,21,.857,119,50,106,.472,32,57,.561,18,49,.367,14,18,.778,132
879,HOU,2023-12-17,119,@,MIL,L 119-128,240,45,85,.529,34,58,.586,11,27,.407,18,21,.857,119,45,90,.500,32,54,.593,13,36,.361,25,32,.781,128
880,ATL,2023-12-16,119,@,CLE,L 119-127,240,41,85,.482,26,49,.531,15,36,.417,22,25,.880,119,49,101,.485,33,59,.559,16,42,.381,13,15,.867,127
881,MIN,2023-12-14,119,@,DAL,W 119-101,240,44,88,.500,30,57,.526,14,31,.452,17,25,.680,119,39,83,.470,32,51,.627,7,32,.219,16,18,.889,101
882,SAS,2023-12-13,119,,LAL,L 119-122,240,45,96,.469,29,59,.492,16,37,.432,13,18,.722,119,49,91,.538,35,56,.625,14,35,.400,10,17,.588,122
883,LAC,2023-12-12,119,,SAC,W 119-99,240,44,84,.524,33,55,.600,11,29,.379,20,21,.952,119,36,86,.419,26,49,.531,10,37,.270,17,24,.708,99
884,PHO,2023-12-12,119,,GSW,W 119-116,240,38,84,.452,24,45,.533,14,39,.359,29,34,.853,119,41,92,.446,25,46,.543,16,46,.348,18,27,.667,116
885,CHO,2023-12-08,119,,TOR,W 119-116,240,44,79,.557,31,54,.574,13,25,.520,18,20,.900,119,47,93,.505,41,61,.672,6,32,.188,16,21,.762,116
886,MIL,2023-12-07,119,,IND,L 119-128,240,43,96,.448,31,63,.492,12,33,.364,21,28,.750,119,50,102,.490,43,69,.623,7,33,.212,21,25,.840,128
887,PHI,2023-12-01,119,@,BOS,L 119-125,240,43,94,.457,27,59,.458,16,35,.457,17,23,.739,119,39,77,.506,23,44,.523,16,33,.485,31,36,.861,125
888,DEN,2023-12-01,119,@,PHO,W 119-111,240,50,88,.568,38,56,.679,12,32,.375,7,12,.583,119,39,84,.464,30,57,.526,9,27,.333,24,26,.923,111
889,NYK,2023-12-01,119,@,TOR,W 119-106,240,45,90,.500,29,54,.537,16,36,.444,13,16,.813,119,44,100,.440,38,68,.559,6,32,.188,12,17,.706,106
890,MIN,2023-11-26,119,@,MEM,W 119-97,240,43,81,.531,28,47,.596,15,34,.441,18,23,.783,119,34,88,.386,24,51,.471,10,37,.270,19,27,.704,97
891,BOS,2023-11-22,119,,MIL,W 119-116,240,44,84,.524,27,42,.643,17,42,.405,14,17,.824,119,45,101,.446,32,67,.478,13,34,.382,13,17,.765,116
892,DEN,2023-11-22,119,@,ORL,L 119-124,240,44,93,.473,29,58,.500,15,35,.429,16,21,.762,119,44,81,.543,34,52,.654,10,29,.345,26,30,.867,124
893,PHI,2023-11-21,119,,CLE,L 119-122 (OT),265,40,96,.417,29,61,.475,11,35,.314,28,34,.824,119,46,94,.489,37,69,.536,9,25,.360,21,25,.840,122
894,CHI,2023-11-12,119,,DET,W 119-108,240,44,91,.484,33,61,.541,11,30,.367,20,25,.800,119,38,88,.432,27,56,.482,11,32,.344,21,26,.808,108
895,PHO,2023-11-10,119,,LAL,L 119-122,240,42,94,.447,27,57,.474,15,37,.405,20,27,.741,119,42,84,.500,30,57,.526,12,27,.444,26,34,.765,122
896,ORL,2023-11-09,119,,ATL,L 119-120,240,42,90,.467,32,63,.508,10,27,.370,25,35,.714,119,41,85,.482,26,46,.565,15,39,.385,23,30,.767,120
897,CHO,2023-11-01,119,@,HOU,L 119-128,240,45,90,.500,34,63,.540,11,27,.407,18,25,.720,119,44,84,.524,23,47,.489,21,37,.568,19,23,.826,128
898,BOS,2023-10-27,119,,MIA,W 119-111,240,45,95,.474,29,56,.518,16,39,.410,13,19,.684,119,38,89,.427,22,56,.393,16,33,.485,19,23,.826,111
899,SAS,2023-10-25,119,,DAL,L 119-126,240,46,89,.517,35,54,.648,11,35,.314,16,22,.727,119,47,99,.475,32,52,.615,15,47,.319,17,23,.739,126
900,DEN,2023-10-24,119,,LAL,W 119-107,240,48,91,.527,34,57,.596,14,34,.412,9,12,.750,119,41,90,.456,31,61,.508,10,29,.345,15,20,.750,107
901,MIA,2024-04-14,118,,TOR,W 118-103,240,46,87,.529,37,51,.725,9,36,.250,17,19,.895,118,38,90,.422,29,56,.518,9,34,.265,18,21,.857,103
902,NYK,2024-04-11,118,@,BOS,W 118-109,240,49,99,.495,35,63,.556,14,36,.389,6,10,.600,118,40,86,.465,24,44,.545,16,42,.381,13,16,.813,109
903,HOU,2024-04-09,118,,ORL,W 118-106,240,45,86,.523,30,51,.588,15,35,.429,13,18,.722,118,39,86,.453,32,62,.516,7,24,.292,21,23,.913,106
904,CLE,2024-04-07,118,@,LAC,L 118-120,240,42,88,.477,31,58,.534,11,30,.367,23,27,.852,118,41,84,.488,27,49,.551,14,35,.400,24,24,1.000,120
905,GSW,2024-04-07,118,,UTA,W 118-110,240,49,92,.533,35,57,.614,14,35,.400,6,6,1.000,118,39,83,.470,24,48,.500,15,35,.429,17,21,.810,110
906,CHO,2024-04-07,118,,OKC,L 118-121,240,45,83,.542,28,43,.651,17,40,.425,11,14,.786,118,45,87,.517,27,51,.529,18,36,.500,13,17,.765,121
907,BOS,2024-04-01,118,@,CHO,W 118-104,240,43,89,.483,24,36,.667,19,53,.358,13,16,.813,118,41,91,.451,28,54,.519,13,37,.351,9,11,.818,104
908,CHO,2024-03-31,118,,LAC,L 118-130,240,44,88,.500,21,36,.583,23,52,.442,7,11,.636,118,43,75,.573,29,46,.630,14,29,.483,30,34,.882,130
909,ORL,2024-03-30,118,,MEM,W 118-88,240,38,78,.487,16,34,.471,22,44,.500,20,23,.870,118,31,86,.360,19,50,.380,12,36,.333,14,17,.824,88
910,SAS,2024-03-27,118,@,UTA,W 118-111,240,44,86,.512,28,53,.528,16,33,.485,14,21,.667,118,39,83,.470,26,48,.542,13,35,.371,20,22,.909,111
911,CHO,2024-03-27,118,,CLE,W 118-111,240,44,76,.579,31,43,.721,13,33,.394,17,22,.773,118,42,85,.494,23,41,.561,19,44,.432,8,14,.571,111
912,BOS,2024-03-25,118,@,ATL,L 118-120,240,47,95,.495,36,57,.632,11,38,.289,13,19,.684,118,46,87,.529,28,51,.549,18,36,.500,10,17,.588,120
913,MIL,2024-03-24,118,,OKC,W 118-93,240,49,92,.533,38,58,.655,11,34,.324,9,14,.643,118,33,89,.371,23,46,.500,10,43,.233,17,22,.773,93
914,OKC,2024-03-16,118,@,MEM,W 118-112,240,45,87,.517,33,52,.635,12,35,.343,16,21,.762,118,37,81,.457,19,37,.514,18,44,.409,20,26,.769,112
915,MIN,2024-03-12,118,@,LAC,W 118-100,240,48,94,.511,36,61,.590,12,33,.364,10,14,.714,118,34,72,.472,23,42,.548,11,30,.367,21,25,.840,100
916,TOR,2024-03-09,118,@,POR,L 118-128 (OT),265,43,91,.473,27,48,.563,16,43,.372,16,19,.842,118,49,103,.476,33,63,.524,16,40,.400,14,15,.933,128
917,DET,2024-03-07,118,,BRK,W 118-112,240,43,82,.524,31,52,.596,12,30,.400,20,21,.952,118,41,84,.488,24,43,.558,17,41,.415,13,18,.722,112
918,MIA,2024-03-05,118,,DET,W 118-110,240,42,85,.494,28,54,.519,14,31,.452,20,23,.870,118,39,89,.438,27,47,.574,12,42,.286,20,22,.909,110
919,OKC,2024-03-03,118,@,PHO,W 118-110,240,49,102,.480,40,71,.563,9,31,.290,11,15,.733,118,40,91,.440,26,52,.500,14,39,.359,16,18,.889,110
920,HOU,2024-03-02,118,@,PHO,W 118-109,240,42,96,.438,26,54,.481,16,42,.381,18,26,.692,118,39,85,.459,30,56,.536,9,29,.310,22,29,.759,109
921,OKC,2024-02-29,118,@,SAS,L 118-132,240,44,89,.494,35,58,.603,9,31,.290,21,22,.955,118,48,91,.527,29,52,.558,19,39,.487,17,20,.850,132
922,SAS,2024-02-23,118,@,LAL,L 118-123,240,42,96,.438,27,58,.466,15,38,.395,19,23,.826,118,49,95,.516,38,68,.559,11,27,.407,14,18,.778,123
923,ORL,2024-02-14,118,,NYK,W 118-100,240,48,76,.632,36,50,.720,12,26,.462,10,11,.909,118,35,84,.417,24,55,.436,11,29,.379,19,24,.792,100
924,BOS,2024-02-13,118,@,BRK,W 118-110,240,43,83,.518,28,46,.609,15,37,.405,17,23,.739,118,39,79,.494,24,46,.522,15,33,.455,17,26,.654,110
925,CLE,2024-02-08,118,@,BRK,W 118-95,240,43,80,.538,28,43,.651,15,37,.405,17,17,1.000,118,37,93,.398,27,68,.397,10,25,.400,11,14,.786,95
926,CHI,2024-02-08,118,@,MEM,W 118-110,240,43,79,.544,31,53,.585,12,26,.462,20,22,.909,118,42,91,.462,24,45,.533,18,46,.391,8,13,.615,110
927,DAL,2024-02-05,118,@,PHI,W 118-102,240,42,87,.483,25,44,.568,17,43,.395,17,23,.739,118,40,93,.430,32,64,.500,8,29,.276,14,20,.700,102
928,CHO,2024-02-05,118,,LAL,L 118-124,240,47,96,.490,34,64,.531,13,32,.406,11,14,.786,118,50,89,.562,42,55,.764,8,34,.235,16,19,.842,124
929,TOR,2024-01-30,118,@,CHI,W 118-107,240,43,83,.518,29,54,.537,14,29,.483,18,20,.900,118,38,75,.507,27,43,.628,11,32,.344,20,27,.741,107
930,NYK,2024-01-30,118,,UTA,W 118-103,240,44,94,.468,31,60,.517,13,34,.382,17,18,.944,118,39,86,.453,27,50,.540,12,36,.333,13,17,.765,103
931,WAS,2024-01-29,118,@,SAS,W 118-113,240,46,86,.535,37,61,.607,9,25,.360,17,24,.708,118,43,92,.467,31,62,.500,12,30,.400,15,17,.882,113
932,PHO,2024-01-29,118,@,MIA,W 118-105,240,46,94,.489,32,54,.593,14,40,.350,12,17,.706,118,33,84,.393,19,48,.396,14,36,.389,25,25,1.000,105
933,BOS,2024-01-29,118,,NOP,W 118-112,240,43,85,.506,26,39,.667,17,46,.370,15,20,.750,118,46,91,.505,36,56,.643,10,35,.286,10,13,.769,112
934,CLE,2024-01-29,118,,LAC,W 118-108,240,42,86,.488,29,46,.630,13,40,.325,21,26,.808,118,38,80,.475,27,46,.587,11,34,.324,21,28,.750,108
935,WAS,2024-01-27,118,@,DET,W 118-104,240,45,100,.450,34,66,.515,11,34,.324,17,21,.810,118,37,85,.435,28,53,.528,9,32,.281,21,27,.778,104
936,MIN,2024-01-24,118,@,WAS,W 118-107,240,42,100,.420,33,68,.485,9,32,.281,25,29,.862,118,37,77,.481,27,53,.509,10,24,.417,23,29,.793,107
937,POR,2024-01-19,118,,IND,W 118-115,240,42,84,.500,38,72,.528,4,12,.333,30,35,.857,118,39,91,.429,19,44,.432,20,47,.426,17,25,.680,115
938,MIN,2024-01-18,118,,MEM,W 118-103,240,45,82,.549,33,54,.611,12,28,.429,16,21,.762,118,39,85,.459,25,51,.490,14,34,.412,11,17,.647,103
939,NOP,2024-01-13,118,@,DAL,W 118-108,240,39,79,.494,27,49,.551,12,30,.400,28,37,.757,118,37,82,.451,22,41,.537,15,41,.366,19,20,.950,108
940,GSW,2024-01-13,118,@,MIL,L 118-129,240,47,98,.480,32,62,.516,15,36,.417,9,14,.643,118,51,94,.543,38,63,.603,13,31,.419,14,17,.824,129
941,GSW,2024-01-07,118,,TOR,L 118-133,240,45,100,.450,31,54,.574,14,46,.304,14,15,.933,118,55,94,.585,40,61,.656,15,33,.455,8,14,.571,133
942,BOS,2024-01-06,118,@,IND,W 118-101,240,46,90,.511,30,49,.612,16,41,.390,10,19,.526,118,38,92,.413,30,50,.600,8,42,.190,17,22,.773,101
943,TOR,2023-12-29,118,@,BOS,L 118-120,240,44,95,.463,27,51,.529,17,44,.386,13,20,.650,118,43,88,.489,26,49,.531,17,39,.436,17,20,.850,120
944,SAS,2023-12-28,118,@,POR,W 118-105,240,41,85,.482,31,49,.633,10,36,.278,26,28,.929,118,35,101,.347,24,65,.369,11,36,.306,24,32,.750,105
945,MIN,2023-12-28,118,,DAL,W 118-110,240,38,74,.514,21,41,.512,17,33,.515,25,34,.735,118,40,90,.444,26,57,.456,14,33,.424,16,19,.842,110
946,SAS,2023-12-26,118,,UTA,L 118-130,240,44,98,.449,28,63,.444,16,35,.457,14,21,.667,118,47,95,.495,31,52,.596,16,43,.372,20,22,.909,130
947,CHI,2023-12-26,118,,ATL,W 118-113,240,42,92,.457,35,67,.522,7,25,.280,27,31,.871,118,41,89,.461,28,44,.636,13,45,.289,18,21,.857,113
948,BRK,2023-12-26,118,@,DET,W 118-112,240,41,82,.500,32,60,.533,9,22,.409,27,43,.628,118,40,90,.444,31,65,.477,9,25,.360,23,32,.719,112
949,WAS,2023-12-22,118,@,GSW,L 118-129,240,44,97,.454,33,62,.532,11,35,.314,19,24,.792,118,47,97,.485,29,52,.558,18,45,.400,17,20,.850,129
950,MIN,2023-12-21,118,,LAL,W 118-111,240,42,87,.483,28,51,.549,14,36,.389,20,25,.800,118,41,83,.494,31,59,.525,10,24,.417,19,24,.792,111
951,WAS,2023-12-21,118,@,POR,W 118-117,240,42,84,.500,30,54,.556,12,30,.400,22,32,.688,118,43,95,.453,29,65,.446,14,30,.467,17,23,.739,117
952,MIL,2023-12-21,118,,ORL,W 118-114,240,38,90,.422,27,53,.509,11,37,.297,31,35,.886,118,45,99,.455,37,66,.561,8,33,.242,16,23,.696,114
953,GSW,2023-12-17,118,@,POR,W 118-114,240,46,87,.529,33,49,.673,13,38,.342,13,19,.684,118,40,85,.471,27,50,.540,13,35,.371,21,23,.913,114
954,OKC,2023-12-16,118,@,DEN,W 118-117,240,43,84,.512,36,63,.571,7,21,.333,25,30,.833,118,42,93,.452,30,61,.492,12,32,.375,21,24,.875,117
955,MIA,2023-12-16,118,,CHI,W 118-116,240,43,83,.518,30,48,.625,13,35,.371,19,25,.760,118,37,77,.481,21,39,.538,16,38,.421,26,29,.897,116
956,BRK,2023-12-11,118,@,SAC,L 118-131,240,42,88,.477,28,59,.475,14,29,.483,20,21,.952,118,48,94,.511,23,49,.469,25,45,.556,10,14,.714,131
957,UTA,2023-12-02,118,,POR,W 118-113 (OT),265,46,94,.489,39,60,.650,7,34,.206,19,24,.792,118,38,95,.400,25,55,.455,13,40,.325,24,27,.889,113
958,NOP,2023-12-02,118,@,CHI,L 118-124,240,41,82,.500,33,57,.579,8,25,.320,28,35,.800,118,48,88,.545,31,48,.646,17,40,.425,11,15,.733,124
959,NYK,2023-11-30,118,,DET,W 118-112,240,41,88,.466,25,47,.532,16,41,.390,20,28,.714,118,43,81,.531,28,46,.609,15,35,.429,11,17,.647,112
960,BRK,2023-11-26,118,,CHI,W 118-109,240,41,83,.494,16,30,.533,25,53,.472,11,15,.733,118,40,83,.482,28,51,.549,12,32,.375,17,22,.773,109
961,GSW,2023-11-24,118,,SAS,W 118-112,240,40,81,.494,21,39,.538,19,42,.452,19,24,.792,118,45,100,.450,33,53,.623,12,47,.255,10,12,.833,112
962,BOS,2023-11-20,118,@,CHO,L 118-121 (OT),265,42,97,.433,26,47,.553,16,50,.320,18,28,.643,118,46,104,.442,33,65,.508,13,39,.333,16,17,.941,121
963,MIA,2023-11-20,118,@,CHI,W 118-100,240,42,84,.500,25,49,.510,17,35,.486,17,20,.850,118,37,81,.457,26,44,.591,11,37,.297,15,16,.938,100
964,MIL,2023-11-13,118,,CHI,W 118-109,240,42,89,.472,27,42,.643,15,47,.319,19,27,.704,118,38,100,.380,24,58,.414,14,42,.333,19,21,.905,109
965,MIA,2023-11-12,118,@,SAS,W 118-113,240,39,89,.438,27,58,.466,12,31,.387,28,30,.933,118,42,91,.462,23,47,.489,19,44,.432,10,12,.833,113
966,CLE,2023-11-11,118,@,GSW,W 118-110,240,37,86,.430,26,56,.464,11,30,.367,33,43,.767,118,37,90,.411,24,52,.462,13,38,.342,23,30,.767,110
967,POR,2023-11-08,118,@,SAC,L 118-121 (OT),265,44,87,.506,36,65,.554,8,22,.364,22,29,.759,118,41,89,.461,30,52,.577,11,37,.297,28,38,.737,121
968,UTA,2023-11-08,118,@,IND,L 118-134,240,45,96,.469,34,69,.493,11,27,.407,17,18,.944,118,52,101,.515,39,60,.650,13,41,.317,17,20,.850,134
969,DET,2023-11-08,118,@,MIL,L 118-120,240,48,98,.490,41,69,.594,7,29,.241,15,16,.938,118,41,90,.456,30,53,.566,11,37,.297,27,32,.844,120
970,CHO,2023-11-05,118,@,DAL,L 118-124,240,49,99,.495,41,69,.594,8,30,.267,12,21,.571,118,43,91,.473,29,49,.592,14,42,.333,24,32,.750,124
971,LAC,2023-10-31,118,,ORL,W 118-102,240,44,89,.494,30,58,.517,14,31,.452,16,23,.696,118,38,81,.469,31,51,.608,7,30,.233,19,33,.576,102
972,DET,2023-10-28,118,,CHI,W 118-102,240,45,86,.523,33,58,.569,12,28,.429,16,20,.800,118,39,93,.419,28,65,.431,11,28,.393,13,16,.813,102
973,LAC,2023-10-27,118,@,UTA,L 118-120,240,41,77,.532,27,42,.643,14,35,.400,22,28,.786,118,42,96,.438,26,55,.473,16,41,.390,20,22,.909,120
974,MIL,2023-10-26,118,,PHI,W 118-117,240,41,81,.506,30,51,.588,11,30,.367,25,36,.694,118,41,80,.513,25,45,.556,16,35,.457,19,28,.679,117
975,MIL,2024-04-10,117,,ORL,W 117-99,240,43,84,.512,28,44,.636,15,40,.375,16,20,.800,117,36,78,.462,25,48,.521,11,30,.367,16,23,.696,99
976,CHI,2024-04-09,117,,NYK,L 117-128,240,47,88,.534,37,60,.617,10,28,.357,13,19,.684,117,46,83,.554,29,47,.617,17,36,.472,19,20,.950,128
977,MIA,2024-04-09,117,@,ATL,W 117-111 (2OT),290,42,88,.477,24,43,.558,18,45,.400,15,21,.714,117,45,113,.398,35,67,.522,10,46,.217,11,14,.786,111
978,LAL,2024-04-07,117,,MIN,L 117-127,240,39,84,.464,28,53,.528,11,31,.355,28,32,.875,117,50,97,.515,35,58,.603,15,39,.385,12,14,.857,127
979,IND,2024-04-07,117,,MIA,W 117-115,240,44,86,.512,35,54,.648,9,32,.281,20,21,.952,117,39,84,.464,31,57,.544,8,27,.296,29,32,.906,115
980,TOR,2024-04-05,117,@,MIL,W 117-111,240,36,79,.456,22,43,.512,14,36,.389,31,36,.861,117,41,94,.436,29,52,.558,12,42,.286,17,21,.810,111
981,ORL,2024-04-03,117,@,NOP,W 117-108,240,41,80,.513,28,48,.583,13,32,.406,22,30,.733,117,36,76,.474,24,47,.511,12,29,.414,24,28,.857,108
982,WAS,2024-04-02,117,,MIL,W 117-113,240,47,93,.505,38,55,.691,9,38,.237,14,17,.824,117,45,103,.437,34,55,.618,11,48,.229,12,18,.667,113
983,GSW,2024-03-31,117,@,SAS,W 117-113,240,45,92,.489,29,53,.547,16,39,.410,11,13,.846,117,40,89,.449,23,46,.500,17,43,.395,16,18,.889,113
984,CLE,2024-03-29,117,,PHI,W 117-114,240,45,82,.549,29,45,.644,16,37,.432,11,13,.846,117,42,94,.447,26,54,.481,16,40,.400,14,17,.824,114
985,POR,2024-03-22,117,,LAC,L 117-125,240,45,93,.484,33,60,.550,12,33,.364,15,25,.600,117,44,77,.571,30,44,.682,14,33,.424,23,27,.852,125
986,CHI,2024-03-21,117,@,HOU,L 117-127,240,42,93,.452,30,62,.484,12,31,.387,21,25,.840,117,47,93,.505,30,48,.625,17,45,.378,16,20,.800,127
987,HOU,2024-03-16,117,,CLE,W 117-103,240,47,98,.480,32,56,.571,15,42,.357,8,12,.667,117,37,82,.451,25,44,.568,12,38,.316,17,20,.850,103
988,DEN,2024-03-15,117,@,SAS,W 117-106,240,49,89,.551,39,64,.609,10,25,.400,9,12,.750,117,37,81,.457,26,52,.500,11,29,.379,21,27,.778,106
989,PHO,2024-03-11,117,@,CLE,W 117-111,240,46,84,.548,34,52,.654,12,32,.375,13,19,.684,117,40,84,.476,25,38,.658,15,46,.326,16,19,.842,111
990,LAC,2024-03-10,117,,MIL,L 117-124,240,47,104,.452,33,57,.579,14,47,.298,9,10,.900,117,43,87,.494,26,49,.531,17,38,.447,21,27,.778,124
991,BOS,2024-03-09,117,@,PHO,W 117-107,240,46,94,.489,31,55,.564,15,39,.385,10,13,.769,117,44,87,.506,35,56,.625,9,31,.290,10,16,.625,107
992,UTA,2024-03-06,117,,CHI,L 117-119,240,44,96,.458,29,49,.592,15,47,.319,14,16,.875,117,45,90,.500,28,51,.549,17,39,.436,12,15,.800,119
993,PHO,2024-03-05,117,@,DEN,W 117-107 (OT),265,42,96,.438,27,62,.435,15,34,.441,18,22,.818,117,41,96,.427,26,56,.464,15,40,.375,10,14,.714,107
994,SAS,2024-03-03,117,,IND,W 117-105,240,46,85,.541,36,60,.600,10,25,.400,15,19,.789,117,41,93,.441,35,63,.556,6,30,.200,17,21,.810,105
995,DEN,2024-02-28,117,,SAC,W 117-96,240,46,86,.535,31,51,.608,15,35,.429,10,11,.909,117,38,95,.400,26,60,.433,12,35,.343,8,13,.615,96
996,BOS,2024-02-27,117,,PHI,W 117-99,240,39,74,.527,34,52,.654,5,22,.227,34,37,.919,117,37,94,.394,23,52,.442,14,42,.333,11,12,.917,99
997,NOP,2024-02-07,117,@,LAC,W 117-106,240,47,88,.534,35,56,.625,12,32,.375,11,16,.688,117,36,78,.462,24,46,.522,12,32,.375,22,26,.846,106
998,ATL,2024-02-07,117,@,BOS,L 117-125,240,43,102,.422,30,61,.492,13,41,.317,18,20,.900,117,49,93,.527,32,44,.727,17,49,.347,10,11,.909,125
999,CHO,2024-02-07,117,,TOR,L 117-123,240,44,90,.489,28,51,.549,16,39,.410,13,20,.650,117,43,81,.531,26,48,.542,17,33,.515,20,24,.833,123
1000,OKC,2024-02-06,117,@,UTA,L 117-124,240,43,90,.478,24,53,.453,19,37,.514,12,18,.667,117,46,89,.517,32,54,.593,14,35,.400,18,20,.900,124
1001,DAL,2024-02-03,117,,MIL,L 117-129,240,40,81,.494,24,42,.571,16,39,.410,21,23,.913,117,50,88,.568,38,58,.655,12,30,.400,17,25,.680,129
1002,CLE,2024-02-03,117,@,SAS,W 117-101,240,46,97,.474,33,53,.623,13,44,.295,12,13,.923,117,36,98,.367,24,58,.414,12,40,.300,17,21,.810,101
1003,CHI,2024-01-31,117,@,CHO,W 117-110,240,45,87,.517,34,58,.586,11,29,.379,16,22,.727,117,40,90,.444,24,44,.545,16,46,.348,14,17,.824,110
1004,NOP,2024-01-27,117,@,MIL,L 117-141,240,40,85,.471,31,62,.500,9,23,.391,28,36,.778,117,51,91,.560,31,46,.674,20,45,.444,19,25,.760,141
1005,PHO,2024-01-21,117,,IND,W 117-110,240,47,82,.573,39,57,.684,8,25,.320,15,18,.833,117,41,94,.436,27,63,.429,14,31,.452,14,23,.609,110
1006,BOS,2024-01-17,117,,SAS,W 117-98,240,42,90,.467,24,52,.462,18,38,.474,15,19,.789,117,39,93,.419,32,59,.542,7,34,.206,13,16,.813,98
1007,DET,2024-01-17,117,,MIN,L 117-124,240,46,89,.517,34,58,.586,12,31,.387,13,19,.684,117,47,93,.505,32,63,.508,15,30,.500,15,21,.714,124
1008,OKC,2024-01-16,117,@,LAC,L 117-128,240,42,83,.506,26,49,.531,16,34,.471,17,20,.850,117,47,87,.540,27,44,.614,20,43,.465,14,23,.609,128
1009,SAC,2024-01-16,117,@,PHO,L 117-119,240,46,92,.500,28,52,.538,18,40,.450,7,12,.583,117,42,85,.494,25,48,.521,17,37,.459,18,20,.900,119
1010,WAS,2024-01-15,117,,DET,L 117-129,240,44,95,.463,25,54,.463,19,41,.463,10,11,.909,117,50,90,.556,38,59,.644,12,31,.387,17,23,.739,129
1011,DEN,2024-01-14,117,,IND,W 117-109,240,46,71,.648,36,51,.706,10,20,.500,15,23,.652,117,43,92,.467,35,63,.556,8,29,.276,15,22,.682,109
1012,ORL,2024-01-07,117,,ATL,W 117-110 (OT),265,43,98,.439,26,57,.456,17,41,.415,14,22,.636,117,42,91,.462,33,61,.541,9,30,.300,17,29,.586,110
1013,CLE,2024-01-07,117,,SAS,W 117-115,240,43,88,.489,27,45,.600,16,43,.372,15,21,.714,117,41,86,.477,27,49,.551,14,37,.378,19,22,.864,115
1014,NOP,2024-01-03,117,@,MIN,W 117-106,240,45,81,.556,33,55,.600,12,26,.462,15,17,.882,117,37,82,.451,27,51,.529,10,31,.323,22,27,.815,106
1015,UTA,2023-12-30,117,,MIA,W 117-109,240,43,93,.462,32,52,.615,11,41,.268,20,28,.714,117,34,78,.436,25,47,.532,9,31,.290,32,40,.800,109
1016,SAC,2023-12-29,117,@,ATL,W 117-110,240,46,89,.517,29,44,.659,17,45,.378,8,15,.533,117,37,94,.394,22,51,.431,15,43,.349,21,25,.840,110
1017,LAC,2023-12-29,117,,MEM,W 117-106,240,43,87,.494,32,48,.667,11,39,.282,20,25,.800,117,38,87,.437,25,47,.532,13,40,.325,17,20,.850,106
1018,ORL,2023-12-29,117,,NYK,W 117-108,240,40,89,.449,33,56,.589,7,33,.212,30,40,.750,117,38,86,.442,32,56,.571,6,30,.200,26,29,.897,108
1019,HOU,2023-12-26,117,,IND,L 117-123,240,47,97,.485,42,73,.575,5,24,.208,18,22,.818,117,43,82,.524,24,39,.615,19,43,.442,18,21,.857,123
1020,ORL,2023-12-23,117,@,IND,W 117-110,240,39,73,.534,33,55,.600,6,18,.333,33,41,.805,117,43,82,.524,28,48,.583,15,34,.441,9,13,.692,110
1021,BRK,2023-12-22,117,,DEN,L 117-122,240,43,89,.483,30,56,.536,13,33,.394,18,26,.692,117,45,87,.517,34,61,.557,11,26,.423,21,25,.840,122
1022,POR,2023-12-21,117,,WAS,L 117-118,240,43,95,.453,29,65,.446,14,30,.467,17,23,.739,117,42,84,.500,30,54,.556,12,30,.400,22,32,.688,118
1023,DEN,2023-12-16,117,,OKC,L 117-118,240,42,93,.452,30,61,.492,12,32,.375,21,24,.875,117,43,84,.512,36,63,.571,7,21,.333,25,30,.833,118
1024,HOU,2023-12-13,117,,MEM,W 117-104,240,39,86,.453,27,54,.500,12,32,.375,27,37,.730,117,35,82,.427,25,44,.568,10,38,.263,24,34,.706,104
1025,UTA,2023-12-13,117,,NYK,W 117-113,240,43,98,.439,27,56,.482,16,42,.381,15,21,.714,117,41,94,.436,32,55,.582,9,39,.231,22,32,.688,113
1026,LAC,2023-12-08,117,@,UTA,W 117-103,240,43,88,.489,28,54,.519,15,34,.441,16,21,.762,117,38,84,.452,29,53,.547,9,31,.290,18,24,.750,103
1027,SAC,2023-12-04,117,,NOP,L 117-127,240,38,85,.447,24,44,.545,14,41,.341,27,33,.818,117,47,87,.540,33,56,.589,14,31,.452,19,23,.826,127
1028,CHO,2023-12-02,117,,MIN,L 117-123,240,44,91,.484,32,66,.485,12,25,.480,17,19,.895,117,43,84,.512,32,53,.604,11,31,.355,26,30,.867,123
1029,DEN,2023-12-02,117,@,SAC,L 117-123,240,49,99,.495,43,74,.581,6,25,.240,13,20,.650,117,48,99,.485,32,65,.492,16,34,.471,11,15,.733,123
1030,SAC,2023-11-29,117,,LAC,L 117-131,240,40,86,.465,27,45,.600,13,41,.317,24,28,.857,117,50,93,.538,36,65,.554,14,28,.500,17,22,.773,131
1031,CHO,2023-11-26,117,@,ORL,L 117-130,240,44,83,.530,31,53,.585,13,30,.433,16,25,.640,117,47,87,.540,37,60,.617,10,27,.370,26,33,.788,130
1032,CHO,2023-11-22,117,,WAS,W 117-114,240,43,91,.473,27,54,.500,16,37,.432,15,21,.714,117,44,97,.454,33,65,.508,11,32,.344,15,18,.833,114
1033,NOP,2023-11-22,117,,SAC,W 117-112,240,41,87,.471,34,57,.596,7,30,.233,28,37,.757,117,34,76,.447,19,32,.594,15,44,.341,29,35,.829,112
1034,MIN,2023-11-20,117,,NYK,W 117-100,240,41,80,.513,30,46,.652,11,34,.324,24,32,.750,117,32,92,.348,23,54,.426,9,38,.237,27,34,.794,100
1035,BOS,2023-11-15,117,@,PHI,W 117-107,240,42,88,.477,24,38,.632,18,50,.360,15,19,.789,117,39,85,.459,28,55,.509,11,30,.367,18,22,.818,107
1036,WAS,2023-11-15,117,,DAL,L 117-130,240,43,89,.483,31,53,.585,12,36,.333,19,23,.826,117,48,92,.522,31,50,.620,17,42,.405,17,29,.586,130
1037,BOS,2023-11-11,117,,TOR,W 117-94,240,47,86,.547,32,42,.762,15,44,.341,8,13,.615,117,35,91,.385,25,54,.463,10,37,.270,14,16,.875,94
1038,MIA,2023-11-11,117,@,ATL,W 117-109,240,41,84,.488,29,46,.630,12,38,.316,23,25,.920,117,38,87,.437,20,41,.488,18,46,.391,15,18,.833,109
1039,WAS,2023-11-10,117,,CHO,L 117-124,240,43,88,.489,29,50,.580,14,38,.368,17,20,.850,117,50,110,.455,44,82,.537,6,28,.214,18,28,.643,124
1040,MIN,2023-11-10,117,@,SAS,W 117-110,240,43,87,.494,33,60,.550,10,27,.370,21,27,.778,117,43,92,.467,31,58,.534,12,34,.353,12,19,.632,110
1041,ATL,2023-11-06,117,@,OKC,L 117-126,240,38,102,.373,24,60,.400,14,42,.333,27,32,.844,117,45,94,.479,31,59,.525,14,35,.400,22,23,.957,126
1042,DAL,2023-11-06,117,@,ORL,W 117-102,240,41,82,.500,26,42,.619,15,40,.375,20,28,.714,117,40,85,.471,32,58,.552,8,27,.296,14,18,.778,102
1043,PHI,2023-10-26,117,@,MIL,L 117-118,240,41,80,.513,25,45,.556,16,35,.457,19,28,.679,117,41,81,.506,30,51,.588,11,30,.367,25,36,.694,118
1044,HOU,2024-04-14,116,@,LAC,W 116-105,240,50,103,.485,39,65,.600,11,38,.289,5,14,.357,116,41,104,.394,33,67,.493,8,37,.216,15,17,.882,105
1045,UTA,2024-04-14,116,@,GSW,L 116-123,240,46,89,.517,32,55,.582,14,34,.412,10,16,.625,116,45,94,.479,31,51,.608,14,43,.326,19,23,.826,123
1046,HOU,2024-04-12,116,@,POR,W 116-107,240,44,92,.478,33,53,.623,11,39,.282,17,20,.850,116,37,95,.389,25,60,.417,12,35,.343,21,29,.724,107
1047,DEN,2024-04-10,116,,MIN,W 116-107,240,46,83,.554,35,58,.603,11,25,.440,13,23,.565,116,41,82,.500,28,52,.538,13,30,.433,12,21,.571,107
1048,PHI,2024-04-06,116,@,MEM,W 116-96,240,41,79,.519,25,40,.625,16,39,.410,18,23,.783,116,36,87,.414,27,61,.443,9,26,.346,15,21,.714,96
1049,LAL,2024-04-06,116,,CLE,W 116-97,240,45,80,.563,29,43,.674,16,37,.432,10,16,.625,116,39,90,.433,28,55,.509,11,35,.314,8,12,.667,97
1050,LAL,2024-03-31,116,@,BRK,W 116-104,240,42,77,.545,27,37,.730,15,40,.375,17,22,.773,116,39,92,.424,27,56,.482,12,36,.333,14,19,.737,104
1051,LAC,2024-03-25,116,,IND,L 116-133,240,46,85,.541,40,65,.615,6,20,.300,18,22,.818,116,50,86,.581,33,58,.569,17,28,.607,16,22,.727,133
1052,LAC,2024-03-20,116,@,POR,W 116-103,240,45,86,.523,32,55,.582,13,31,.419,13,15,.867,116,39,81,.481,24,47,.511,15,34,.441,10,15,.667,103
1053,MEM,2024-03-20,116,@,GSW,L 116-137,240,42,96,.438,24,47,.511,18,49,.367,14,18,.778,116,58,100,.580,39,61,.639,19,39,.487,2,6,.333,137
1054,CLE,2024-03-13,116,@,NOP,W 116-95,240,47,92,.511,27,47,.574,20,45,.444,2,3,.667,116,35,80,.438,31,58,.534,4,22,.182,21,26,.808,95
1055,NOP,2024-03-10,116,@,ATL,W 116-103,240,43,75,.573,29,48,.604,14,27,.519,16,22,.727,116,38,91,.418,21,45,.467,17,46,.370,10,13,.769,103
1056,HOU,2024-03-06,116,,LAC,L 116-122,240,45,94,.479,29,57,.509,16,37,.432,10,17,.588,116,44,80,.550,32,51,.627,12,29,.414,22,26,.846,122
1057,ATL,2024-03-05,116,@,NYK,W 116-100,240,44,87,.506,34,56,.607,10,31,.323,18,23,.783,116,38,99,.384,22,47,.468,16,52,.308,8,11,.727,100
1058,LAL,2024-03-04,116,,OKC,W 116-104,240,41,80,.513,25,46,.543,16,34,.471,18,25,.720,116,37,94,.394,22,55,.400,15,39,.385,15,16,.938,104
1059,DAL,2024-03-03,116,,PHI,L 116-120,240,40,86,.465,24,45,.533,16,41,.390,20,23,.870,116,40,88,.455,29,51,.569,11,37,.297,29,31,.935,120
1060,LAL,2024-02-28,116,@,LAC,W 116-112,240,47,86,.547,33,50,.660,14,36,.389,8,10,.800,116,45,89,.506,35,52,.673,10,37,.270,12,16,.750,112
1061,BOS,2024-02-24,116,@,NYK,W 116-102,240,46,81,.568,31,46,.674,15,35,.429,9,12,.750,116,37,82,.451,24,44,.545,13,38,.342,15,16,.938,102
1062,ORL,2024-02-22,116,@,CLE,W 116-109,240,43,84,.512,29,59,.492,14,25,.560,16,18,.889,116,39,70,.557,29,48,.604,10,22,.455,21,26,.808,109
1063,DAL,2024-02-14,116,,SAS,W 116-93,240,49,92,.533,38,62,.613,11,30,.367,7,10,.700,116,36,100,.360,26,60,.433,10,40,.250,11,15,.733,93
1064,PHO,2024-02-14,116,,DET,W 116-100,240,35,77,.455,25,46,.543,10,31,.323,36,44,.818,116,38,99,.384,28,62,.452,10,37,.270,14,22,.636,100
1065,MIA,2024-02-07,116,,SAS,W 116-104,240,43,87,.494,31,49,.633,12,38,.316,18,23,.783,116,41,90,.456,29,53,.547,12,37,.324,10,17,.588,104
1066,MIL,2024-01-31,116,@,POR,L 116-119,240,45,92,.489,32,47,.681,13,45,.289,13,18,.722,116,49,92,.533,37,64,.578,12,28,.429,9,9,1.000,119
1067,IND,2024-01-28,116,,MEM,W 116-110,240,44,90,.489,31,55,.564,13,35,.371,15,16,.938,116,38,82,.463,27,52,.519,11,30,.367,23,31,.742,110
1068,SAS,2024-01-26,116,,POR,W 116-100,240,42,92,.457,32,58,.552,10,34,.294,22,26,.846,116,38,90,.422,28,53,.528,10,37,.270,14,19,.737,100
1069,CLE,2024-01-24,116,@,MIL,L 116-126,240,46,91,.505,33,53,.623,13,38,.342,11,15,.733,116,45,90,.500,34,61,.557,11,29,.379,25,28,.893,126
1070,LAL,2024-01-23,116,@,LAC,L 116-127,240,45,92,.489,34,60,.567,11,32,.344,15,22,.682,116,52,88,.591,38,61,.623,14,27,.519,9,12,.750,127
1071,BOS,2024-01-21,116,@,HOU,W 116-107,240,43,98,.439,26,51,.510,17,47,.362,13,18,.722,116,41,94,.436,31,59,.525,10,35,.286,15,22,.682,107
1072,CLE,2024-01-20,116,@,ATL,W 116-95,240,43,85,.506,27,42,.643,16,43,.372,14,16,.875,116,37,93,.398,26,55,.473,11,38,.289,10,15,.667,95
1073,CHI,2024-01-18,116,@,TOR,W 116-110,240,48,91,.527,42,67,.627,6,24,.250,14,17,.824,116,42,83,.506,32,45,.711,10,38,.263,16,20,.800,110
1074,MEM,2024-01-15,116,,GSW,W 116-107,240,32,86,.372,12,32,.375,20,54,.370,32,40,.800,116,44,90,.489,34,59,.576,10,31,.323,9,10,.900,107
1075,POR,2024-01-14,116,,PHO,L 116-127,240,40,89,.449,20,47,.426,20,42,.476,16,22,.727,116,46,76,.605,33,48,.688,13,28,.464,22,27,.815,127
1076,SAS,2024-01-13,116,,CHI,L 116-122,240,39,95,.411,21,49,.429,18,46,.391,20,23,.870,116,46,90,.511,31,56,.554,15,34,.441,15,20,.750,122
1077,MIN,2024-01-12,116,,POR,W 116-93,240,44,80,.550,33,49,.673,11,31,.355,17,24,.708,116,30,77,.390,20,49,.408,10,28,.357,23,34,.676,93
1078,MIL,2024-01-08,116,,UTA,L 116-132,240,42,94,.447,25,58,.431,17,36,.472,15,19,.789,116,47,90,.522,27,46,.587,20,44,.455,18,22,.818,132
1079,ATL,2024-01-05,116,@,IND,L 116-150,240,40,93,.430,30,51,.588,10,42,.238,26,30,.867,116,60,94,.638,41,55,.745,19,39,.487,11,13,.846,150
1080,TOR,2024-01-03,116,@,MEM,W 116-111,240,41,85,.482,29,59,.492,12,26,.462,22,27,.815,116,40,94,.426,25,52,.481,15,42,.357,16,19,.842,111
1081,NYK,2024-01-03,116,,CHI,W 116-100,240,46,89,.517,31,51,.608,15,38,.395,9,11,.818,116,37,89,.416,24,57,.421,13,32,.406,13,16,.813,100
1082,MEM,2023-12-26,116,@,NOP,W 116-115 (OT),265,39,90,.433,28,44,.636,11,46,.239,27,32,.844,116,42,97,.433,32,66,.485,10,31,.323,21,33,.636,115
1083,MEM,2023-12-21,116,,IND,W 116-103,240,43,84,.512,27,49,.551,16,35,.457,14,21,.667,116,38,90,.422,20,38,.526,18,52,.346,9,11,.818,103
1084,UTA,2023-12-20,116,@,CLE,L 116-124,240,40,78,.513,27,48,.563,13,30,.433,23,28,.821,116,45,96,.469,22,45,.489,23,51,.451,11,16,.688,124
1085,OKC,2023-12-18,116,,MEM,W 116-97,240,42,92,.457,31,56,.554,11,36,.306,21,23,.913,116,30,85,.353,11,31,.355,19,54,.352,18,21,.857,97
1086,CHI,2023-12-16,116,@,MIA,L 116-118,240,37,77,.481,21,39,.538,16,38,.421,26,29,.897,116,43,83,.518,30,48,.625,13,35,.371,19,25,.760,118
1087,MIA,2023-12-14,116,,CHI,L 116-124,240,37,80,.463,22,46,.478,15,34,.441,27,35,.771,116,45,93,.484,31,57,.544,14,36,.389,20,30,.667,124
1088,BOS,2023-12-14,116,,CLE,W 116-107,240,43,85,.506,30,49,.612,13,36,.361,17,20,.850,116,40,83,.482,29,50,.580,11,33,.333,16,17,.941,107
1089,BRK,2023-12-13,116,@,PHO,W 116-112,240,41,89,.461,26,48,.542,15,41,.366,19,24,.792,116,40,84,.476,31,56,.554,9,28,.321,23,27,.852,112
1090,GSW,2023-12-12,116,@,PHO,L 116-119,240,41,92,.446,25,46,.543,16,46,.348,18,27,.667,116,38,84,.452,24,45,.533,14,39,.359,29,34,.853,119
1091,MIA,2023-12-11,116,@,CHO,W 116-114,240,37,77,.481,22,42,.524,15,35,.429,27,34,.794,116,40,84,.476,23,43,.535,17,41,.415,17,22,.773,114
1092,TOR,2023-12-08,116,@,CHO,L 116-119,240,47,93,.505,41,61,.672,6,32,.188,16,21,.762,116,44,79,.557,31,54,.574,13,25,.520,18,20,.900,119
1093,MEM,2023-12-06,116,@,DET,W 116-102,240,47,91,.516,36,65,.554,11,26,.423,11,14,.786,116,41,91,.451,30,56,.536,11,35,.314,9,9,1.000,102
1094,PHO,2023-12-02,116,,MEM,W 116-109,240,36,83,.434,27,57,.474,9,26,.346,35,43,.814,116,39,86,.453,30,55,.545,9,31,.290,22,24,.917,109
1095,PHO,2023-11-26,116,@,NYK,W 116-113,240,42,91,.462,26,53,.491,16,38,.421,16,21,.762,116,39,86,.453,27,57,.474,12,29,.414,23,32,.719,113
1096,NOP,2023-11-24,116,@,LAC,W 116-106,240,43,88,.489,33,64,.516,10,24,.417,20,27,.741,116,42,92,.457,31,55,.564,11,37,.297,11,17,.647,106
1097,OKC,2023-11-22,116,,CHI,W 116-102,240,37,75,.493,26,46,.565,11,29,.379,31,38,.816,116,34,88,.386,17,44,.386,17,44,.386,17,17,1.000,102
1098,MIL,2023-11-22,116,@,BOS,L 116-119,240,45,101,.446,32,67,.478,13,34,.382,13,17,.765,116,44,84,.524,27,42,.643,17,42,.405,14,17,.824,119
1099,HOU,2023-11-20,116,@,GSW,L 116-121,240,44,95,.463,31,54,.574,13,41,.317,15,19,.789,116,36,77,.468,15,34,.441,21,43,.488,28,33,.848,121
1100,IND,2023-11-19,116,,ORL,L 116-128,240,42,95,.442,34,64,.531,8,31,.258,24,31,.774,116,43,87,.494,36,67,.537,7,20,.350,35,42,.833,128
1101,ATL,2023-11-17,116,,PHI,L 116-126,240,40,89,.449,28,56,.500,12,33,.364,24,30,.800,116,43,88,.489,30,58,.517,13,30,.433,27,28,.964,126
1102,NYK,2023-11-15,116,@,ATL,W 116-114,240,45,94,.479,29,60,.483,16,34,.471,10,11,.909,116,41,75,.547,29,44,.659,12,31,.387,20,26,.769,114
1103,LAL,2023-11-12,116,,POR,W 116-110,240,41,84,.488,37,65,.569,4,19,.211,30,37,.811,116,45,90,.500,32,53,.604,13,37,.351,7,9,.778,110
1104,MIN,2023-11-12,116,@,GSW,W 116-110,240,43,82,.524,34,55,.618,9,27,.333,21,30,.700,116,37,96,.385,25,53,.472,12,43,.279,24,28,.857,110
1105,DAL,2023-11-08,116,,TOR,L 116-127,240,40,84,.476,23,43,.535,17,41,.415,19,31,.613,116,49,99,.495,38,63,.603,11,36,.306,18,27,.667,127
1106,PHO,2023-11-08,116,@,CHI,W 116-115 (OT),265,38,90,.422,19,42,.452,19,48,.396,21,25,.840,116,42,96,.438,28,63,.444,14,33,.424,17,23,.739,115
1107,CHO,2023-11-08,116,,WAS,L 116-132,240,41,79,.519,33,54,.611,8,25,.320,26,35,.743,116,47,97,.485,29,54,.537,18,43,.419,20,25,.800,132
1108,NOP,2023-11-06,116,@,DEN,L 116-134,240,45,90,.500,32,60,.533,13,30,.433,13,15,.867,116,51,95,.537,36,56,.643,15,39,.385,17,23,.739,134
1109,SAS,2023-11-05,116,,TOR,L 116-123 (OT),265,48,96,.500,38,64,.594,10,32,.313,10,13,.769,116,44,97,.454,25,49,.510,19,48,.396,16,26,.615,123
1110,CLE,2023-11-03,116,@,IND,L 116-121,240,44,84,.524,36,56,.643,8,28,.286,20,25,.800,116,45,86,.523,30,55,.545,15,31,.484,16,24,.667,121
1111,DET,2023-11-02,116,@,NOP,L 116-125,240,41,94,.436,28,56,.500,13,38,.342,21,26,.808,116,39,80,.488,25,48,.521,14,32,.438,33,35,.943,125
1112,CHO,2023-10-25,116,,ATL,W 116-110,240,43,86,.500,32,49,.653,11,37,.297,19,26,.731,116,39,93,.419,34,64,.531,5,29,.172,27,33,.818,110
1113,ORL,2023-10-25,116,,HOU,W 116-86,240,42,87,.483,33,53,.623,9,34,.265,23,26,.885,116,32,79,.405,20,45,.444,12,34,.353,10,16,.625,86
1114,ATL,2024-04-14,115,@,IND,L 115-157,240,39,89,.438,27,53,.509,12,36,.333,25,27,.926,115,65,100,.650,46,64,.719,19,36,.528,8,10,.800,157
1115,CHO,2024-04-10,115,@,ATL,W 115-114,240,40,79,.506,26,43,.605,14,36,.389,21,22,.955,115,43,82,.524,25,42,.595,18,40,.450,10,16,.625,114
1116,MIA,2024-04-07,115,@,IND,L 115-117,240,39,84,.464,31,57,.544,8,27,.296,29,32,.906,115,44,86,.512,35,54,.648,9,32,.281,20,21,.952,117
1117,ORL,2024-04-05,115,@,CHO,L 115-124,240,42,94,.447,33,56,.589,9,38,.237,22,26,.846,115,43,72,.597,28,42,.667,15,30,.500,23,23,1.000,124
1118,BRK,2024-04-03,115,,IND,W 115-111,240,42,87,.483,30,55,.545,12,32,.375,19,27,.704,115,46,103,.447,36,65,.554,10,38,.263,9,11,.818,111
1119,GSW,2024-03-29,115,@,CHO,W 115-97,240,48,89,.539,37,57,.649,11,32,.344,8,9,.889,115,34,84,.405,22,38,.579,12,46,.261,17,24,.708,97
1120,DAL,2024-03-25,115,@,UTA,W 115-105,240,44,92,.478,32,50,.640,12,42,.286,15,18,.833,115,37,87,.425,24,48,.500,13,39,.333,18,22,.818,105
1121,CLE,2024-03-25,115,,CHO,W 115-92,240,46,86,.535,29,45,.644,17,41,.415,6,10,.600,115,34,80,.425,25,52,.481,9,28,.321,15,18,.833,92
1122,ATL,2024-03-21,115,@,PHO,L 115-128,240,40,91,.440,28,56,.500,12,35,.343,23,29,.793,115,41,74,.554,19,33,.576,22,41,.537,24,27,.889,128
1123,MIL,2024-03-21,115,,BRK,W 115-108,240,43,91,.473,27,50,.540,16,41,.390,13,15,.867,115,41,92,.446,28,48,.583,13,44,.295,13,16,.813,108
1124,PHO,2024-03-20,115,,PHI,W 115-102,240,45,90,.500,26,51,.510,19,39,.487,6,8,.750,115,41,95,.432,28,58,.483,13,37,.351,7,18,.389,102
1125,DEN,2024-03-19,115,@,MIN,W 115-112,240,42,81,.519,28,54,.519,14,27,.519,17,22,.773,115,42,88,.477,30,53,.566,12,35,.343,16,23,.696,112
1126,BRK,2024-03-17,115,@,SAS,L 115-122 (OT),265,47,102,.461,39,71,.549,8,31,.258,13,19,.684,115,46,99,.465,37,62,.597,9,37,.243,21,23,.913,122
1127,DEN,2024-03-07,115,,BOS,W 115-109,240,45,90,.500,41,69,.594,4,21,.190,21,22,.955,115,41,91,.451,30,53,.566,11,38,.289,16,25,.640,109
1128,MEM,2024-03-06,115,@,PHI,W 115-109,240,41,91,.451,28,54,.519,13,37,.351,20,23,.870,115,39,102,.382,26,67,.388,13,35,.371,18,21,.857,109
1129,WAS,2024-03-04,115,@,UTA,L 115-127,240,40,94,.426,24,56,.429,16,38,.421,19,23,.826,115,49,101,.485,33,61,.541,16,40,.400,13,15,.867,127
1130,WAS,2024-03-01,115,@,LAC,L 115-140,240,46,98,.469,34,64,.531,12,34,.353,11,15,.733,115,54,94,.574,41,62,.661,13,32,.406,19,25,.760,140
1131,ORL,2024-02-29,115,,UTA,W 115-107,240,42,77,.545,32,47,.681,10,30,.333,21,31,.677,115,34,80,.425,18,43,.419,16,37,.432,23,28,.821,107
1132,NOP,2024-02-27,115,@,NYK,W 115-92,240,39,77,.506,21,43,.488,18,34,.529,19,23,.826,115,31,83,.373,17,37,.459,14,46,.304,16,23,.696,92
1133,DET,2024-02-22,115,@,IND,L 115-129,240,47,89,.528,35,59,.593,12,30,.400,9,18,.500,115,50,94,.532,37,64,.578,13,30,.433,16,19,.842,129
1134,CHO,2024-02-22,115,@,UTA,W 115-107,240,40,92,.435,20,50,.400,20,42,.476,15,22,.682,115,37,86,.430,28,47,.596,9,39,.231,24,27,.889,107
1135,CHO,2024-02-10,115,,MEM,W 115-106,240,47,82,.573,31,51,.608,16,31,.516,5,7,.714,115,43,92,.467,27,48,.563,16,44,.364,4,8,.500,106
1136,UTA,2024-02-08,115,@,PHO,L 115-129,240,41,94,.436,29,59,.492,12,35,.343,21,31,.677,115,52,88,.591,38,59,.644,14,29,.483,11,16,.688,129
1137,IND,2024-02-04,115,@,CHO,W 115-99,240,45,92,.489,34,59,.576,11,33,.333,14,18,.778,115,35,88,.398,27,59,.458,8,29,.276,21,25,.840,99
1138,CHI,2024-02-03,115,,SAC,L 115-123,240,42,91,.462,31,57,.544,11,34,.324,20,22,.909,115,42,84,.500,27,45,.600,15,39,.385,24,29,.828,123
1139,MIA,2024-01-31,115,,SAC,W 115-106,240,42,84,.500,29,56,.518,13,28,.464,18,23,.783,115,41,93,.441,29,53,.547,12,40,.300,12,18,.667,106
1140,DAL,2024-01-27,115,,SAC,L 115-120,240,43,98,.439,27,52,.519,16,46,.348,13,18,.722,115,43,80,.538,32,50,.640,11,30,.367,23,30,.767,120
1141,LAC,2024-01-27,115,@,BOS,W 115-96,240,45,102,.441,35,62,.565,10,40,.250,15,18,.833,115,36,100,.360,26,60,.433,10,40,.250,14,16,.875,96
1142,PHO,2024-01-22,115,,CHI,W 115-113,240,44,85,.518,30,51,.588,14,34,.412,13,17,.765,115,45,93,.484,31,56,.554,14,37,.378,9,14,.643,113
1143,IND,2024-01-19,115,@,POR,L 115-118,240,39,91,.429,19,44,.432,20,47,.426,17,25,.680,115,42,84,.500,38,72,.528,4,12,.333,30,35,.857,118
1144,HOU,2024-01-15,115,@,PHI,L 115-124,240,44,88,.500,36,61,.590,8,27,.296,19,32,.594,115,40,83,.482,25,52,.481,15,31,.484,29,34,.853,124
1145,DAL,2024-01-07,115,,MIN,W 115-108,240,43,95,.453,28,55,.509,15,40,.375,14,20,.700,115,41,94,.436,28,53,.528,13,41,.317,13,21,.619,108
1146,PHO,2024-01-07,115,,MEM,L 115-121,240,46,102,.451,38,74,.514,8,28,.286,15,22,.682,115,43,97,.443,26,48,.542,17,49,.347,18,24,.750,121
1147,SAS,2024-01-07,115,@,CLE,L 115-117,240,41,86,.477,27,49,.551,14,37,.378,19,22,.864,115,43,88,.489,27,45,.600,16,43,.372,15,21,.714,117
1148,OKC,2024-01-05,115,@,BRK,L 115-124,240,45,84,.536,36,53,.679,9,31,.290,16,24,.667,115,41,91,.451,27,52,.519,14,39,.359,28,33,.848,124
1149,ORL,2024-01-02,115,@,GSW,L 115-121,240,41,92,.446,27,56,.482,14,36,.389,19,23,.826,115,42,78,.538,29,43,.674,13,35,.371,24,37,.649,121
1150,NOP,2023-12-26,115,,MEM,L 115-116 (OT),265,42,97,.433,32,66,.485,10,31,.323,21,33,.636,115,39,90,.433,28,44,.636,11,46,.239,27,32,.844,116
1151,LAL,2023-12-25,115,,BOS,L 115-126,240,43,90,.478,30,58,.517,13,32,.406,16,21,.762,115,46,91,.505,33,49,.673,13,42,.310,21,28,.750,126
1152,DET,2023-12-23,115,@,BRK,L 115-126,240,39,79,.494,24,44,.545,15,35,.429,22,29,.759,115,45,86,.523,35,62,.565,10,24,.417,26,32,.813,126
1153,LAC,2023-12-21,115,@,OKC,L 115-134,240,44,93,.473,27,50,.540,17,43,.395,10,12,.833,115,51,87,.586,35,53,.660,16,34,.471,16,18,.889,134
1154,MIA,2023-12-20,115,@,ORL,W 115-106,240,40,83,.482,25,54,.463,15,29,.517,20,24,.833,115,41,89,.461,32,53,.604,9,36,.250,15,19,.789,106
1155,MEM,2023-12-19,115,@,NOP,W 115-113,240,41,82,.500,31,51,.608,10,31,.323,23,29,.793,115,40,85,.471,29,60,.483,11,25,.440,22,24,.917,113
1156,LAL,2023-12-15,115,@,SAS,L 115-129,240,43,89,.483,32,53,.604,11,36,.306,18,28,.643,115,47,95,.495,29,53,.547,18,42,.429,17,19,.895,129
1157,MIA,2023-12-13,115,,CHO,W 115-104,240,41,86,.477,26,56,.464,15,30,.500,18,19,.947,115,41,77,.532,29,46,.630,12,31,.387,10,11,.909,104
1158,NYK,2023-11-28,115,,CHO,W 115-91,240,41,88,.466,26,50,.520,15,38,.395,18,20,.900,115,37,89,.416,24,58,.414,13,31,.419,4,7,.571,91
1159,HOU,2023-11-28,115,@,DAL,L 115-121,240,42,85,.494,34,56,.607,8,29,.276,23,29,.793,115,42,89,.472,30,55,.545,12,34,.353,25,29,.862,121
1160,BRK,2023-11-28,115,,TOR,W 115-103,240,40,89,.449,27,51,.529,13,38,.342,22,26,.846,115,39,101,.386,26,65,.400,13,36,.361,12,19,.632,103
1161,CLE,2023-11-25,115,,LAL,L 115-121,240,43,91,.473,34,63,.540,9,28,.321,20,23,.870,115,47,90,.522,38,63,.603,9,27,.333,18,21,.857,121
1162,GSW,2023-11-22,115,@,PHO,L 115-123,240,43,90,.478,33,58,.569,10,32,.313,19,29,.655,115,34,76,.447,23,48,.479,11,28,.393,44,52,.846,123
1163,NOP,2023-11-17,115,,DEN,W 115-110,240,46,88,.523,34,65,.523,12,23,.522,11,21,.524,115,47,96,.490,37,56,.661,10,40,.250,6,12,.500,110
1164,BRK,2023-11-16,115,@,MIA,L 115-122,240,40,85,.471,26,49,.531,14,36,.389,21,27,.778,115,42,81,.519,27,46,.587,15,35,.429,23,24,.958,122
1165,MIN,2023-11-15,115,@,PHO,L 115-133,240,42,92,.457,37,65,.569,5,27,.185,26,28,.929,115,51,85,.600,34,54,.630,17,31,.548,14,15,.933,133
1166,UTA,2023-11-14,115,,POR,W 115-99,240,44,95,.463,31,52,.596,13,43,.302,14,15,.933,115,37,88,.420,26,53,.491,11,35,.314,14,20,.700,99
1167,CHI,2023-11-08,115,,PHO,L 115-116 (OT),265,42,96,.438,28,63,.444,14,33,.424,17,23,.739,115,38,90,.422,19,42,.452,19,48,.396,21,25,.840,116
1168,CLE,2023-11-05,115,,GSW,W 115-104,240,41,83,.494,30,46,.652,11,37,.297,22,28,.786,115,34,94,.362,18,53,.340,16,41,.390,20,30,.667,104
1169,POR,2023-11-03,115,,MEM,W 115-113 (OT),265,39,96,.406,30,64,.469,9,32,.281,28,36,.778,115,47,96,.490,37,61,.607,10,35,.286,9,13,.692,113
1170,ORL,2023-11-02,115,@,UTA,W 115-113,240,39,85,.459,29,56,.518,10,29,.345,27,36,.750,115,41,89,.461,29,56,.518,12,33,.364,19,26,.731,113
1171,SAS,2023-10-31,115,@,PHO,W 115-114,240,43,92,.467,29,55,.527,14,37,.378,15,20,.750,115,42,83,.506,24,44,.545,18,39,.462,12,15,.800,114
1172,NOP,2024-04-12,114,@,GSW,W 114-109,240,42,90,.467,22,52,.423,20,38,.526,10,16,.625,114,40,86,.465,27,52,.519,13,34,.382,16,21,.762,109
1173,ATL,2024-04-10,114,,CHO,L 114-115,240,43,82,.524,25,42,.595,18,40,.450,10,16,.625,114,40,79,.506,26,43,.605,14,36,.389,21,22,.955,115
1174,PHI,2024-03-29,114,@,CLE,L 114-117,240,42,94,.447,26,54,.481,16,40,.400,14,17,.824,114,45,82,.549,29,45,.644,16,37,.432,11,13,.846,117
1175,MIN,2024-03-24,114,,GSW,W 114-110,240,40,84,.476,19,44,.432,21,40,.525,13,18,.722,114,38,85,.447,24,49,.490,14,36,.389,20,26,.769,110
1176,NOP,2024-03-24,114,@,DET,W 114-101,240,41,81,.506,30,47,.638,11,34,.324,21,31,.677,114,32,79,.405,21,38,.553,11,41,.268,26,32,.813,101
1177,DEN,2024-03-23,114,@,POR,W 114-111,240,41,91,.451,33,67,.493,8,24,.333,24,33,.727,114,43,93,.462,33,65,.508,10,28,.357,15,17,.882,111
1178,WAS,2024-03-19,114,,HOU,L 114-137,240,42,98,.429,27,59,.458,15,39,.385,15,20,.750,114,47,91,.516,34,52,.654,13,39,.333,30,36,.833,137
1179,MIN,2024-03-18,114,@,UTA,W 114-104,240,44,91,.484,28,50,.560,16,41,.390,10,12,.833,114,39,84,.464,25,52,.481,14,32,.438,12,14,.857,104
1180,MIL,2024-03-14,114,,PHI,W 114-105,240,39,72,.542,23,36,.639,16,36,.444,20,24,.833,114,39,79,.494,22,44,.500,17,35,.486,10,14,.714,105
1181,ORL,2024-03-13,114,,BRK,W 114-106,240,40,77,.519,26,45,.578,14,32,.438,20,26,.769,114,38,81,.469,31,55,.564,7,26,.269,23,27,.852,106
1182,DET,2024-03-11,114,,CHO,W 114-97,240,41,86,.477,31,44,.705,10,42,.238,22,24,.917,114,34,88,.386,21,48,.438,13,40,.325,16,23,.696,97
1183,DAL,2024-03-07,114,,MIA,W 114-108,240,40,87,.460,24,46,.522,16,41,.390,18,23,.783,114,40,82,.488,23,44,.523,17,38,.447,11,17,.647,108
1184,HOU,2024-03-05,114,,SAS,W 114-101,240,49,105,.467,40,71,.563,9,34,.265,7,11,.636,114,38,87,.437,26,51,.510,12,36,.333,13,16,.813,101
1185,POR,2024-03-04,114,@,MIN,L 114-119,240,45,92,.489,29,53,.547,16,39,.410,8,11,.727,114,40,79,.506,29,51,.569,11,28,.393,28,37,.757,119
1186,LAL,2024-03-02,114,,DEN,L 114-124,240,47,89,.528,35,60,.583,12,29,.414,8,11,.727,114,54,92,.587,43,66,.652,11,26,.423,5,7,.714,124
1187,BRK,2024-03-02,114,,ATL,W 114-102,240,41,88,.466,26,56,.464,15,32,.469,17,22,.773,114,37,87,.425,26,53,.491,11,34,.324,17,23,.739,102
1188,CHO,2024-03-01,114,@,PHI,L 114-121,240,43,84,.512,29,51,.569,14,33,.424,14,17,.824,114,46,96,.479,27,52,.519,19,44,.432,10,11,.909,121
1189,NOP,2024-02-28,114,@,IND,L 114-123,240,42,90,.467,31,61,.508,11,29,.379,19,23,.826,114,50,102,.490,36,64,.563,14,38,.368,9,9,1.000,123
1190,MIN,2024-02-27,114,,SAS,W 114-105,240,43,93,.462,30,62,.484,13,31,.419,15,17,.882,114,39,82,.476,23,41,.561,16,41,.390,11,15,.733,105
1191,CLE,2024-02-25,114,@,WAS,W 114-105,240,42,83,.506,32,51,.627,10,32,.313,20,27,.741,114,40,90,.444,28,50,.560,12,40,.300,13,18,.722,105
1192,CHI,2024-02-25,114,@,NOP,W 114-106,240,41,95,.432,28,55,.509,13,40,.325,19,21,.905,114,40,88,.455,24,47,.511,16,41,.390,10,14,.714,106
1193,HOU,2024-02-23,114,,PHO,W 114-110,240,37,93,.398,22,48,.458,15,45,.333,25,34,.735,114,38,95,.400,31,64,.484,7,31,.226,27,35,.771,110
1194,ORL,2024-02-10,114,,CHI,W 114-108 (OT),265,41,88,.466,28,49,.571,13,39,.333,19,26,.731,114,43,99,.434,31,62,.500,12,37,.324,10,14,.714,108
1195,DEN,2024-02-08,114,@,LAL,W 114-106,240,47,97,.485,33,65,.508,14,32,.438,6,7,.857,114,41,89,.461,33,64,.516,8,25,.320,16,22,.727,106
1196,CLE,2024-02-07,114,@,WAS,W 114-106,240,43,88,.489,31,53,.585,12,35,.343,16,22,.727,114,42,94,.447,26,54,.481,16,40,.400,6,9,.667,106
1197,PHO,2024-02-06,114,,MIL,W 114-106,240,44,87,.506,36,59,.610,8,28,.286,18,27,.667,114,39,90,.433,26,50,.520,13,40,.325,15,25,.600,106
1198,NOP,2024-02-02,114,@,SAS,W 114-113,240,46,95,.484,39,69,.565,7,26,.269,15,21,.714,114,46,96,.479,36,57,.632,10,39,.256,11,18,.611,113
1199,LAL,2024-02-01,114,@,BOS,W 114-105,240,38,94,.404,19,58,.328,19,36,.528,19,26,.731,114,41,97,.423,25,49,.510,16,48,.333,7,7,1.000,105
1200,UTA,2024-01-29,114,@,BRK,L 114-147,240,39,86,.453,30,59,.508,9,27,.333,27,34,.794,114,54,105,.514,33,60,.550,21,45,.467,18,19,.947,147
1201,SAS,2024-01-24,114,,OKC,L 114-140,240,43,86,.500,34,54,.630,9,32,.281,19,25,.760,114,54,96,.563,36,56,.643,18,40,.450,14,16,.875,140
1202,DEN,2024-01-23,114,@,IND,W 114-109,240,44,88,.500,33,55,.600,11,33,.333,15,17,.882,114,43,87,.494,38,66,.576,5,21,.238,18,21,.857,109
1203,BRK,2024-01-21,114,@,LAC,L 114-125,240,44,90,.489,30,51,.588,14,39,.359,12,16,.750,114,42,83,.506,29,57,.509,13,26,.500,28,33,.848,125
1204,DET,2024-01-07,114,@,DEN,L 114-131,240,42,89,.472,33,65,.508,9,24,.375,21,30,.700,114,47,80,.588,37,53,.698,10,27,.370,27,31,.871,131
1205,CLE,2024-01-05,114,,WAS,W 114-90,240,41,77,.532,25,44,.568,16,33,.485,16,23,.696,114,35,84,.417,26,54,.481,9,30,.300,11,15,.733,90
1206,MIA,2023-12-28,114,@,GSW,W 114-102,240,44,91,.484,34,60,.567,10,31,.323,16,22,.727,114,37,88,.420,29,55,.527,8,33,.242,20,25,.800,102
1207,GSW,2023-12-25,114,@,DEN,L 114-120,240,40,87,.460,26,47,.553,14,40,.350,20,23,.870,114,40,82,.488,26,48,.542,14,34,.412,26,32,.813,120
1208,PHO,2023-12-25,114,,DAL,L 114-128,240,40,90,.444,26,49,.531,14,41,.341,20,25,.800,114,45,84,.536,29,40,.725,16,44,.364,22,30,.733,128
1209,ORL,2023-12-21,114,@,MIL,L 114-118,240,45,99,.455,37,66,.561,8,33,.242,16,23,.696,114,38,90,.422,27,53,.509,11,37,.297,31,35,.886,118
1210,CHI,2023-12-21,114,,SAS,W 114-95,240,49,90,.544,42,62,.677,7,28,.250,9,11,.818,114,37,81,.457,27,51,.529,10,30,.333,11,16,.688,95
1211,TOR,2023-12-18,114,,CHO,W 114-99,240,44,86,.512,36,57,.632,8,29,.276,18,22,.818,114,39,89,.438,31,57,.544,8,32,.250,13,13,1.000,99
1212,NYK,2023-12-18,114,@,LAL,W 114-109,240,42,88,.477,32,58,.552,10,30,.333,20,23,.870,114,42,99,.424,29,58,.500,13,41,.317,12,13,.923,109
1213,POR,2023-12-17,114,,GSW,L 114-118,240,40,85,.471,27,50,.540,13,35,.371,21,23,.913,114,46,87,.529,33,49,.673,13,38,.342,13,19,.684,118
1214,BOS,2023-12-17,114,,ORL,W 114-97,240,45,95,.474,28,59,.475,17,36,.472,7,8,.875,114,34,89,.382,23,53,.434,11,36,.306,18,24,.750,97
1215,DET,2023-12-16,114,@,MIL,L 114-146,240,43,96,.448,37,68,.544,6,28,.214,22,26,.846,114,50,88,.568,31,46,.674,19,42,.452,27,32,.844,146
1216,POR,2023-12-14,114,,UTA,L 114-122,240,43,103,.417,27,58,.466,16,45,.356,12,18,.667,114,49,92,.533,38,59,.644,11,33,.333,13,14,.929,122
1217,DEN,2023-12-12,114,@,CHI,W 114-106,240,39,83,.470,25,53,.472,14,30,.467,22,32,.688,114,36,86,.419,23,46,.500,13,40,.325,21,23,.913,106
1218,CHO,2023-12-11,114,,MIA,L 114-116,240,40,84,.476,23,43,.535,17,41,.415,17,22,.773,114,37,77,.481,22,42,.524,15,35,.429,27,34,.794,116
1219,ATL,2023-12-08,114,@,PHI,L 114-125,240,41,104,.394,28,65,.431,13,39,.333,19,21,.905,114,42,87,.483,31,57,.544,11,30,.367,30,37,.811,125
1220,HOU,2023-12-08,114,@,DEN,W 114-106,240,35,82,.427,22,43,.512,13,39,.333,31,42,.738,114,38,90,.422,28,62,.452,10,28,.357,20,27,.741,106
1221,SAC,2023-12-08,114,@,PHO,W 114-106,240,42,92,.457,28,53,.528,14,39,.359,16,20,.800,114,40,83,.482,29,51,.569,11,32,.344,15,23,.652,106
1222,BRK,2023-12-06,114,@,ATL,W 114-113,240,43,94,.457,32,67,.478,11,27,.407,17,24,.708,114,42,94,.447,30,59,.508,12,35,.343,17,18,.944,113
1223,LAC,2023-11-30,114,@,GSW,L 114-120,240,42,95,.442,30,63,.476,12,32,.375,18,24,.750,114,41,82,.500,26,43,.605,15,39,.385,23,31,.742,120
1224,PHI,2023-11-29,114,@,NOP,L 114-124,240,42,81,.519,28,47,.596,14,34,.412,16,18,.889,114,42,78,.538,32,48,.667,10,30,.333,30,34,.882,124
1225,UTA,2023-11-27,114,,NOP,W 114-112,240,37,88,.420,20,40,.500,17,48,.354,23,28,.821,114,44,88,.500,37,66,.561,7,22,.318,17,25,.680,112
1226,POR,2023-11-27,114,@,IND,W 114-110,240,40,85,.471,31,67,.463,9,18,.500,25,31,.806,114,42,88,.477,34,55,.618,8,33,.242,18,24,.750,110
1227,WAS,2023-11-22,114,@,CHO,L 114-117,240,44,97,.454,33,65,.508,11,32,.344,15,18,.833,114,43,91,.473,27,54,.500,16,37,.432,15,21,.714,117
1228,ATL,2023-11-15,114,,NYK,L 114-116,240,41,75,.547,29,44,.659,12,31,.387,20,26,.769,114,45,94,.479,29,60,.483,16,34,.471,10,11,.909,116
1229,BOS,2023-11-13,114,,NYK,W 114-98,240,40,79,.506,21,36,.583,19,43,.442,15,16,.938,114,33,79,.418,18,44,.409,15,35,.429,17,24,.708,98
1230,PHI,2023-11-10,114,@,DET,W 114-106,240,35,83,.422,26,55,.473,9,28,.321,35,41,.854,114,40,86,.465,32,58,.552,8,28,.286,18,22,.818,106
1231,MIN,2023-11-06,114,,BOS,W 114-109 (OT),265,44,85,.518,31,48,.646,13,37,.351,13,25,.520,114,36,92,.391,25,53,.472,11,39,.282,26,34,.765,109
1232,BRK,2023-11-04,114,,BOS,L 114-124,240,43,100,.430,26,48,.542,17,52,.327,11,17,.647,114,43,90,.478,28,45,.622,15,45,.333,23,27,.852,124
1233,DAL,2023-11-03,114,@,DEN,L 114-125,240,41,86,.477,24,44,.545,17,42,.405,15,17,.882,114,49,93,.527,36,63,.571,13,30,.433,14,19,.737,125
1234,WAS,2023-11-03,114,@,MIA,L 114-121,240,46,81,.568,33,53,.623,13,28,.464,9,17,.529,114,48,80,.600,35,53,.660,13,27,.481,12,14,.857,121
1235,PHI,2023-11-02,114,,TOR,W 114-99,240,42,92,.457,33,67,.493,9,25,.360,21,25,.840,114,38,79,.481,28,51,.549,10,28,.357,13,19,.684,99
1236,DAL,2023-11-01,114,,CHI,W 114-105,240,37,81,.457,17,33,.515,20,48,.417,20,28,.714,114,42,89,.472,31,56,.554,11,33,.333,10,11,.909,105
1237,PHO,2023-10-31,114,,SAS,L 114-115,240,42,83,.506,24,44,.545,18,39,.462,12,15,.800,114,43,92,.467,29,55,.527,14,37,.378,15,20,.750,115
1238,MIA,2023-10-30,114,@,MIL,L 114-122,240,41,86,.477,28,52,.538,13,34,.382,19,20,.950,114,44,87,.506,32,50,.640,12,37,.324,22,30,.733,122
1239,PHI,2023-10-28,114,@,TOR,W 114-107,240,43,86,.500,33,58,.569,10,28,.357,18,21,.857,114,38,87,.437,21,55,.382,17,32,.531,14,19,.737,107
1240,SAC,2023-10-27,114,,GSW,L 114-122,240,41,94,.436,29,54,.537,12,40,.300,20,29,.690,114,48,87,.552,34,55,.618,14,32,.438,12,14,.857,122
1241,CLE,2023-10-25,114,@,BRK,W 114-113,240,44,94,.468,27,51,.529,17,43,.395,9,10,.900,114,42,84,.500,33,57,.579,9,27,.333,20,26,.769,113
1242,UTA,2023-10-25,114,,SAC,L 114-130,240,41,91,.451,32,63,.508,9,28,.321,23,31,.742,114,47,102,.461,28,51,.549,19,51,.373,17,20,.850,130
1243,ORL,2024-04-14,113,,MIL,W 113-88,240,42,85,.494,31,50,.620,11,35,.314,18,19,.947,113,30,75,.400,23,48,.479,7,27,.259,21,23,.913,88
1244,ORL,2024-04-12,113,@,PHI,L 113-125,240,43,95,.453,35,68,.515,8,27,.296,19,25,.760,113,42,88,.477,24,51,.471,18,37,.486,23,28,.821,125
1245,ORL,2024-04-07,113,,CHI,W 113-98,240,42,90,.467,31,56,.554,11,34,.324,18,19,.947,113,38,75,.507,32,55,.582,6,20,.300,16,22,.727,98
1246,NOP,2024-04-07,113,@,PHO,W 113-105,240,40,85,.471,24,46,.522,16,39,.410,17,19,.895,113,39,87,.448,25,48,.521,14,39,.359,13,14,.929,105
1247,BRK,2024-04-06,113,,DET,W 113-103,240,38,73,.521,27,46,.587,11,27,.407,26,33,.788,113,42,92,.457,25,53,.472,17,39,.436,2,4,.500,103
1248,DET,2024-04-03,113,@,ATL,L 113-121,240,43,94,.457,33,64,.516,10,30,.333,17,21,.810,113,49,90,.544,36,52,.692,13,38,.342,10,15,.667,121
1249,MIL,2024-04-02,113,@,WAS,L 113-117,240,45,103,.437,34,55,.618,11,48,.229,12,18,.667,113,47,93,.505,38,55,.691,9,38,.237,14,17,.824,117
1250,UTA,2024-04-02,113,,CLE,L 113-129,240,41,85,.482,25,48,.521,16,37,.432,15,18,.833,113,46,85,.541,30,46,.652,16,39,.410,21,24,.875,129
1251,MIN,2024-04-02,113,,HOU,W 113-106,240,41,77,.532,30,51,.588,11,26,.423,20,22,.909,113,41,92,.446,27,44,.614,14,48,.292,10,14,.714,106
1252,ATL,2024-04-01,113,@,CHI,W 113-101,240,41,82,.500,22,42,.524,19,40,.475,12,18,.667,113,37,94,.394,30,66,.455,7,28,.250,20,24,.833,101
1253,SAS,2024-03-31,113,,GSW,L 113-117,240,40,89,.449,23,46,.500,17,43,.395,16,18,.889,113,45,92,.489,29,53,.547,16,39,.410,11,13,.846,117
1254,OKC,2024-03-31,113,@,NYK,W 113-112,240,44,82,.537,31,48,.646,13,34,.382,12,24,.500,113,38,92,.413,25,49,.510,13,43,.302,23,34,.676,112
1255,ATL,2024-03-30,113,,MIL,L 113-122,240,42,92,.457,28,57,.491,14,35,.400,15,18,.833,113,43,78,.551,35,50,.700,8,28,.286,28,35,.800,122
1256,GSW,2024-03-26,113,@,MIA,W 113-92,240,47,85,.553,34,47,.723,13,38,.342,6,10,.600,113,37,92,.402,29,59,.492,8,33,.242,10,13,.769,92
1257,CHI,2024-03-23,113,,BOS,L 113-124,240,47,82,.573,38,58,.655,9,24,.375,10,11,.909,113,44,86,.512,23,38,.605,21,48,.438,15,17,.882,124
1258,DEN,2024-03-21,113,,NYK,W 113-100,240,45,84,.536,39,64,.609,6,20,.300,17,20,.850,113,38,79,.481,27,48,.563,11,31,.355,13,17,.765,100
1259,DAL,2024-03-21,113,,UTA,W 113-97,240,43,86,.500,33,54,.611,10,32,.313,17,28,.607,113,38,83,.458,34,53,.642,4,30,.133,17,19,.895,97
1260,DAL,2024-03-19,113,@,SAS,W 113-107,240,44,91,.484,34,61,.557,10,30,.333,15,17,.882,113,39,89,.438,25,50,.500,14,39,.359,15,21,.714,107
1261,ORL,2024-03-15,113,@,TOR,W 113-103,240,40,80,.500,26,49,.531,14,31,.452,19,22,.864,113,38,81,.469,24,47,.511,14,34,.412,13,20,.650,103
1262,DET,2024-03-13,113,,TOR,W 113-104,240,39,88,.443,28,58,.483,11,30,.367,24,31,.774,113,41,93,.441,32,57,.561,9,36,.250,13,19,.684,104
1263,GSW,2024-03-09,113,,SAS,L 113-126,240,41,88,.466,31,58,.534,10,30,.333,21,29,.724,113,44,86,.512,27,53,.509,17,33,.515,21,28,.750,126
1264,CLE,2024-03-08,113,,MIN,W 113-104 (OT),265,38,88,.432,27,54,.500,11,34,.324,26,36,.722,113,39,94,.415,31,64,.484,8,30,.267,18,22,.818,104
1265,MIN,2024-03-07,113,@,IND,W 113-111,240,46,98,.469,39,73,.534,7,25,.280,14,19,.737,113,42,82,.512,32,56,.571,10,26,.385,17,23,.739,111
1266,TOR,2024-03-07,113,@,PHO,L 113-120,240,43,94,.457,27,50,.540,16,44,.364,11,15,.733,113,44,86,.512,29,51,.569,15,35,.429,17,20,.850,120
1267,CHI,2024-03-04,113,@,SAC,W 113-109,240,42,84,.500,31,52,.596,11,32,.344,18,22,.818,113,41,92,.446,30,55,.545,11,37,.297,16,18,.889,109
1268,MIL,2024-03-04,113,,LAC,W 113-106,240,37,78,.474,22,40,.550,15,38,.395,24,28,.857,113,37,84,.440,21,44,.477,16,40,.400,16,25,.640,106
1269,ORL,2024-03-03,113,,DET,W 113-91,240,43,72,.597,36,49,.735,7,23,.304,20,25,.800,113,33,86,.384,25,50,.500,8,36,.222,17,20,.850,91
1270,MIL,2024-03-01,113,@,CHI,W 113-97,240,37,86,.430,22,40,.550,15,46,.326,24,32,.750,113,36,86,.419,25,59,.424,11,27,.407,14,16,.875,97
1271,NYK,2024-02-26,113,,DET,W 113-111,240,41,92,.446,26,53,.491,15,39,.385,16,21,.762,113,38,79,.481,24,49,.490,14,30,.467,21,26,.808,111
1272,LAL,2024-02-25,113,@,PHO,L 113-123,240,47,90,.522,32,55,.582,15,35,.429,4,8,.500,113,44,93,.473,27,53,.509,17,40,.425,18,19,.947,123
1273,PHO,2024-02-22,113,@,DAL,L 113-123,240,40,83,.482,25,47,.532,15,36,.417,18,24,.750,113,43,90,.478,24,46,.522,19,44,.432,18,21,.857,123
1274,MEM,2024-02-15,113,,MIL,W 113-110,240,44,83,.530,31,57,.544,13,26,.500,12,19,.632,113,42,90,.467,31,46,.674,11,44,.250,15,20,.750,110
1275,HOU,2024-02-14,113,@,MEM,L 113-121,240,42,102,.412,31,66,.470,11,36,.306,18,28,.643,113,39,79,.494,24,44,.545,15,35,.429,28,41,.683,121
1276,ORL,2024-02-13,113,,OKC,L 113-127,240,41,91,.451,30,55,.545,11,36,.306,20,25,.800,113,46,84,.548,33,52,.635,13,32,.406,22,24,.917,127
1277,SAC,2024-02-11,113,@,OKC,L 113-127,240,44,90,.489,28,48,.583,16,42,.381,9,13,.692,113,46,85,.541,33,58,.569,13,27,.481,22,27,.815,127
1278,WAS,2024-02-10,113,,PHI,L 113-119,240,42,86,.488,29,51,.569,13,35,.371,16,21,.762,113,48,100,.480,40,73,.548,8,27,.296,15,23,.652,119
1279,GSW,2024-02-10,113,,PHO,W 113-112,240,45,101,.446,28,60,.467,17,41,.415,6,11,.545,113,43,94,.457,32,60,.533,11,34,.324,15,16,.938,112
1280,HOU,2024-02-10,113,@,ATL,L 113-122,240,44,100,.440,31,57,.544,13,43,.302,12,19,.632,113,40,88,.455,26,47,.553,14,41,.341,28,37,.757,122
1281,MEM,2024-02-06,113,@,NYK,L 113-123,240,41,80,.513,20,43,.465,21,37,.568,10,16,.625,113,48,86,.558,37,59,.627,11,27,.407,16,20,.800,123
1282,LAL,2024-02-03,113,@,NYK,W 113-105,240,39,80,.488,27,49,.551,12,31,.387,23,27,.852,113,41,100,.410,31,65,.477,10,35,.286,13,15,.867,105
1283,SAS,2024-02-02,113,,NOP,L 113-114,240,46,96,.479,36,57,.632,10,39,.256,11,18,.611,113,46,95,.484,39,69,.565,7,26,.269,15,21,.714,114
1284,SAS,2024-01-29,113,,WAS,L 113-118,240,43,92,.467,31,62,.500,12,30,.400,15,17,.882,113,46,86,.535,37,61,.607,9,25,.360,17,24,.708,118
1285,DEN,2024-01-29,113,,MIL,W 113-107,240,44,91,.484,40,73,.548,4,18,.222,21,24,.875,113,36,84,.429,20,44,.455,16,40,.400,19,25,.760,107
1286,NYK,2024-01-29,113,@,CHO,W 113-92,240,44,84,.524,32,47,.681,12,37,.324,13,16,.813,113,37,81,.457,26,49,.531,11,32,.344,7,14,.500,92
1287,ORL,2024-01-28,113,,PHO,W 113-98,240,41,92,.446,29,56,.518,12,36,.333,19,26,.731,113,41,73,.562,37,59,.627,4,14,.286,12,21,.571,98
1288,SAS,2024-01-27,113,,MIN,W 113-112,240,46,84,.548,33,54,.611,13,30,.433,8,15,.533,113,45,79,.570,31,53,.585,14,26,.538,8,15,.533,112
1289,DET,2024-01-24,113,,CHO,W 113-106,240,43,86,.500,28,48,.583,15,38,.395,12,20,.600,113,38,87,.437,23,49,.469,15,38,.395,15,19,.789,106
1290,CHI,2024-01-22,113,@,PHO,L 113-115,240,45,93,.484,31,56,.554,14,37,.378,9,14,.643,113,44,85,.518,30,51,.588,14,34,.412,13,17,.765,115
1291,DET,2024-01-22,113,,MIL,L 113-122,240,40,89,.449,30,59,.508,10,30,.333,23,29,.793,113,42,94,.447,32,55,.582,10,39,.256,28,34,.824,122
1292,DEN,2024-01-21,113,@,WAS,W 113-104,240,43,88,.489,35,66,.530,8,22,.364,19,28,.679,113,39,91,.429,31,64,.484,8,27,.296,18,22,.818,104
1293,NYK,2024-01-18,113,,WAS,W 113-109,240,39,86,.453,26,48,.542,13,38,.342,22,26,.846,113,41,90,.456,31,59,.525,10,31,.323,17,22,.773,109
1294,HOU,2024-01-13,113,@,BOS,L 113-145,240,40,99,.404,33,69,.478,7,30,.233,26,30,.867,113,51,95,.537,27,48,.563,24,47,.511,19,25,.760,145
1295,TOR,2024-01-12,113,@,UTA,L 113-145,240,35,81,.432,18,47,.383,17,34,.500,26,37,.703,113,52,93,.559,31,50,.620,21,43,.488,20,26,.769,145
1296,NOP,2024-01-12,113,@,DEN,L 113-125,240,42,89,.472,29,56,.518,13,33,.394,16,22,.727,113,50,90,.556,36,57,.632,14,33,.424,11,15,.733,125
1297,MIN,2024-01-09,113,@,ORL,W 113-92,240,43,80,.538,31,50,.620,12,30,.400,15,19,.789,113,34,94,.362,21,52,.404,13,42,.310,11,18,.611,92
1298,HOU,2024-01-08,113,@,MIA,L 113-120,240,37,88,.420,23,47,.489,14,41,.341,25,28,.893,113,41,82,.500,26,46,.565,15,36,.417,23,32,.719,120
1299,LAL,2024-01-05,113,,MEM,L 113-127,240,42,85,.494,32,57,.561,10,28,.357,19,27,.704,113,44,82,.537,21,37,.568,23,45,.511,16,20,.800,127
1300,GSW,2024-01-05,113,,DET,W 113-109,240,38,82,.463,22,44,.500,16,38,.421,21,25,.840,113,44,98,.449,31,54,.574,13,44,.295,8,10,.800,109
1301,PHO,2024-01-05,113,,MIA,W 113-97,240,44,87,.506,30,52,.577,14,35,.400,11,17,.647,113,34,83,.410,24,46,.522,10,37,.270,19,22,.864,97
1302,MIL,2024-01-01,113,,IND,L 113-122,240,41,93,.441,31,53,.585,10,40,.250,21,26,.808,113,43,97,.443,38,62,.613,5,35,.143,31,38,.816,122
1303,DET,2024-01-01,113,@,HOU,L 113-136,240,40,83,.482,27,54,.500,13,29,.448,20,27,.741,113,51,91,.560,36,56,.643,15,35,.429,19,24,.792,136
1304,CLE,2023-12-27,113,@,DAL,W 113-110,240,40,92,.435,23,49,.469,17,43,.395,16,23,.696,113,39,88,.443,29,51,.569,10,37,.270,22,26,.846,110
1305,HOU,2023-12-27,113,,PHO,L 113-129,240,40,96,.417,23,55,.418,17,41,.415,16,22,.727,113,47,82,.573,33,49,.673,14,33,.424,21,26,.808,129
1306,ATL,2023-12-26,113,@,CHI,L 113-118,240,41,89,.461,28,44,.636,13,45,.289,18,21,.857,113,42,92,.457,35,67,.522,7,25,.280,27,31,.871,118
1307,LAC,2023-12-26,113,,CHO,W 113-104,240,40,85,.471,26,51,.510,14,34,.412,19,25,.760,113,43,93,.462,37,64,.578,6,29,.207,12,16,.750,104
1308,SAC,2023-12-26,113,@,POR,L 113-130,240,45,93,.484,35,51,.686,10,42,.238,13,16,.813,113,49,98,.500,33,58,.569,16,40,.400,16,20,.800,130
1309,PHI,2023-12-25,113,@,MIA,L 113-119,240,40,94,.426,23,49,.469,17,45,.378,16,25,.640,113,40,84,.476,28,52,.538,12,32,.375,27,35,.771,119
1310,ATL,2023-12-22,113,@,MIA,L 113-122,240,42,96,.438,23,42,.548,19,54,.352,10,14,.714,113,40,86,.465,23,47,.489,17,39,.436,25,30,.833,122
1311,CHO,2023-12-20,113,@,IND,L 113-144,240,45,95,.474,37,64,.578,8,31,.258,15,19,.789,113,49,80,.613,31,41,.756,18,39,.462,28,30,.933,144
1312,DEN,2023-12-20,113,@,TOR,W 113-104,240,49,98,.500,37,65,.569,12,33,.364,3,7,.429,113,43,90,.478,34,63,.540,9,27,.333,9,13,.692,104
1313,MIN,2023-12-20,113,@,PHI,L 113-127,240,42,82,.512,33,57,.579,9,25,.360,20,24,.833,113,45,84,.536,37,62,.597,8,22,.364,29,32,.906,127
1314,NOP,2023-12-19,113,,MEM,L 113-115,240,40,85,.471,29,60,.483,11,25,.440,22,24,.917,113,41,82,.500,31,51,.608,10,31,.323,23,29,.793,115
1315,GSW,2023-12-14,113,@,LAC,L 113-121,240,40,92,.435,24,47,.511,16,45,.356,17,19,.895,113,41,81,.506,28,49,.571,13,32,.406,26,30,.867,121
1316,NYK,2023-12-13,113,@,UTA,L 113-117,240,41,94,.436,32,55,.582,9,39,.231,22,32,.688,113,43,98,.439,27,56,.482,16,42,.381,15,21,.714,117
1317,CLE,2023-12-12,113,@,BOS,L 113-120,240,44,92,.478,25,47,.532,19,45,.422,6,9,.667,113,38,84,.452,20,40,.500,18,44,.409,26,26,1.000,120
1318,MEM,2023-12-11,113,,DAL,L 113-120,240,41,89,.461,23,45,.511,18,44,.409,13,16,.813,113,43,86,.500,26,46,.565,17,40,.425,17,19,.895,120
1319,ATL,2023-12-06,113,,BRK,L 113-114,240,42,94,.447,30,59,.508,12,35,.343,17,18,.944,113,43,94,.457,32,67,.478,11,27,.407,17,24,.708,114
1320,LAC,2023-12-02,113,,GSW,W 113-112,240,44,90,.489,31,51,.608,13,39,.333,12,14,.857,113,38,86,.442,21,43,.488,17,43,.395,19,24,.792,112
1321,POR,2023-12-02,113,@,UTA,L 113-118 (OT),265,38,95,.400,25,55,.455,13,40,.325,24,27,.889,113,46,94,.489,39,60,.650,7,34,.206,19,24,.792,118
1322,MIL,2023-11-30,113,@,CHI,L 113-120 (OT),265,44,98,.449,28,50,.560,16,48,.333,9,13,.692,113,45,98,.459,32,61,.525,13,37,.351,17,22,.773,120
1323,DEN,2023-11-27,113,@,LAC,W 113-104,240,44,92,.478,34,70,.486,10,22,.455,15,28,.536,113,35,85,.412,29,65,.446,6,20,.300,28,34,.824,104
1324,NYK,2023-11-26,113,,PHO,L 113-116,240,39,86,.453,27,57,.474,12,29,.414,23,32,.719,113,42,91,.462,26,53,.491,16,38,.421,16,21,.762,116
1325,BOS,2023-11-26,113,,ATL,W 113-103,240,42,95,.442,29,48,.604,13,47,.277,16,20,.800,113,36,88,.409,17,35,.486,19,53,.358,12,19,.632,103
1326,ORL,2023-11-24,113,,BOS,W 113-96,240,43,85,.506,32,57,.561,11,28,.393,16,22,.727,113,31,76,.408,24,47,.511,7,29,.241,27,37,.730,96
1327,DET,2023-11-24,113,@,IND,L 113-136,240,43,90,.478,36,72,.500,7,18,.389,20,24,.833,113,49,102,.480,33,64,.516,16,38,.421,22,24,.917,136
1328,DET,2023-11-19,113,@,TOR,L 113-142,240,39,83,.470,30,57,.526,9,26,.346,26,35,.743,113,55,102,.539,41,66,.621,14,36,.389,18,29,.621,142
1329,DAL,2023-11-19,113,,SAC,L 113-129,240,41,88,.466,29,54,.537,12,34,.353,19,26,.731,113,48,90,.533,31,50,.620,17,40,.425,16,21,.762,129
1330,SAS,2023-11-12,113,,MIA,L 113-118,240,42,91,.462,23,47,.489,19,44,.432,10,12,.833,113,39,89,.438,27,58,.466,12,31,.387,28,30,.933,118
1331,UTA,2023-11-06,113,@,CHI,L 113-130,240,41,86,.477,25,43,.581,16,43,.372,15,17,.882,113,48,93,.516,30,59,.508,18,34,.529,16,19,.842,130
1332,MEM,2023-11-03,113,@,POR,L 113-115 (OT),265,47,96,.490,37,61,.607,10,35,.286,9,13,.692,113,39,96,.406,30,64,.469,9,32,.281,28,36,.778,115
1333,UTA,2023-11-02,113,,ORL,L 113-115,240,41,89,.461,29,56,.518,12,33,.364,19,26,.731,113,39,85,.459,29,56,.518,10,29,.345,27,36,.750,115
1334,MIN,2023-10-30,113,@,ATL,L 113-127,240,44,90,.489,28,57,.491,16,33,.485,9,15,.600,113,48,86,.558,34,56,.607,14,30,.467,17,18,.944,127
1335,CLE,2023-10-28,113,,IND,L 113-125,240,43,99,.434,31,68,.456,12,31,.387,15,24,.625,113,48,98,.490,33,60,.550,15,38,.395,14,17,.824,125
1336,WAS,2023-10-28,113,,MEM,W 113-106,240,40,93,.430,24,47,.511,16,46,.348,17,22,.773,113,39,91,.429,20,44,.455,19,47,.404,9,9,1.000,106
1337,BRK,2023-10-25,113,,CLE,L 113-114,240,42,84,.500,33,57,.579,9,27,.333,20,26,.769,113,44,94,.468,27,51,.529,17,43,.395,9,10,.900,114
1338,OKC,2024-04-09,112,,SAC,W 112-105,240,39,80,.488,28,50,.560,11,30,.367,23,31,.742,112,33,96,.344,13,38,.342,20,58,.345,19,26,.731,105
1339,OKC,2024-04-05,112,@,IND,L 112-126,240,42,86,.488,34,56,.607,8,30,.267,20,24,.833,112,46,88,.523,31,53,.585,15,35,.429,19,21,.905,126
1340,NYK,2024-03-31,112,,OKC,L 112-113,240,38,92,.413,25,49,.510,13,43,.302,23,34,.676,112,44,82,.537,31,48,.646,13,34,.382,12,24,.500,113
1341,NOP,2024-03-26,112,,OKC,L 112-119,240,39,86,.453,25,48,.521,14,38,.368,20,23,.870,112,46,86,.535,31,52,.596,15,34,.441,12,14,.857,119
1342,WAS,2024-03-23,112,,TOR,W 112-109,240,44,92,.478,33,57,.579,11,35,.314,13,19,.684,112,40,94,.426,32,61,.525,8,33,.242,21,26,.808,109
1343,MIN,2024-03-19,112,,DEN,L 112-115,240,42,88,.477,30,53,.566,12,35,.343,16,23,.696,112,42,81,.519,28,54,.519,14,27,.519,17,22,.773,115
1344,ORL,2024-03-19,112,,CHO,W 112-92,240,44,81,.543,32,47,.681,12,34,.353,12,13,.923,112,38,79,.481,29,50,.580,9,29,.310,7,9,.778,92
1345,GSW,2024-03-18,112,,NYK,L 112-119,240,42,88,.477,28,52,.538,14,36,.389,14,18,.778,112,44,91,.484,30,54,.556,14,37,.378,17,20,.850,119
1346,MEM,2024-03-16,112,,OKC,L 112-118,240,37,81,.457,19,37,.514,18,44,.409,20,26,.769,112,45,87,.517,33,52,.635,12,35,.343,16,21,.762,118
1347,NOP,2024-03-15,112,,LAC,W 112-104,240,42,87,.483,29,52,.558,13,35,.371,15,20,.750,112,37,77,.481,25,44,.568,12,33,.364,18,19,.947,104
1348,PHO,2024-03-14,112,@,BOS,L 112-127,240,47,99,.475,36,68,.529,11,31,.355,7,10,.700,112,47,89,.528,22,39,.564,25,50,.500,8,11,.727,127
1349,GSW,2024-03-11,112,@,SAS,W 112-102,240,46,93,.495,34,66,.515,12,27,.444,8,12,.667,112,39,93,.419,25,56,.446,14,37,.378,10,15,.667,102
1350,HOU,2024-03-10,112,@,SAC,W 112-104,240,39,84,.464,27,55,.491,12,29,.414,22,27,.815,112,39,86,.453,33,54,.611,6,32,.188,20,23,.870,104
1351,LAC,2024-03-09,112,,CHI,W 112-102,240,42,84,.500,30,49,.612,12,35,.343,16,18,.889,112,37,86,.430,24,51,.471,13,35,.371,15,19,.789,102
1352,WAS,2024-03-08,112,,CHO,W 112-100,240,43,87,.494,37,54,.685,6,33,.182,20,23,.870,112,40,100,.400,31,58,.534,9,42,.214,11,15,.733,100
1353,BRK,2024-03-07,112,@,DET,L 112-118,240,41,84,.488,24,43,.558,17,41,.415,13,18,.722,112,43,82,.524,31,52,.596,12,30,.400,20,21,.952,118
1354,ATL,2024-03-06,112,,CLE,W 112-101,240,43,84,.512,32,54,.593,11,30,.367,15,20,.750,112,39,89,.438,29,45,.644,10,44,.227,13,17,.765,101
1355,BRK,2024-03-05,112,,PHI,W 112-107,240,41,84,.488,29,54,.537,12,30,.400,18,24,.750,112,40,82,.488,28,54,.519,12,28,.429,15,19,.789,107
1356,LAC,2024-02-28,112,,LAL,L 112-116,240,45,89,.506,35,52,.673,10,37,.270,12,16,.750,112,47,86,.547,33,50,.660,14,36,.389,8,10,.800,116
1357,WAS,2024-02-27,112,,GSW,L 112-123,240,46,93,.495,34,58,.586,12,35,.343,8,10,.800,112,47,94,.500,26,48,.542,21,46,.457,8,11,.727,123
1358,OKC,2024-02-27,112,,HOU,W 112-95,240,44,93,.473,34,66,.515,10,27,.370,14,18,.778,112,37,95,.389,28,56,.500,9,39,.231,12,18,.667,95
1359,ORL,2024-02-24,112,@,DET,W 112-109,240,43,87,.494,31,63,.492,12,24,.500,14,21,.667,112,43,85,.506,29,54,.537,14,31,.452,9,13,.692,109
1360,POR,2024-02-23,112,,DEN,L 112-127,240,46,101,.455,38,76,.500,8,25,.320,12,18,.667,112,50,85,.588,37,52,.712,13,33,.394,14,22,.636,127
1361,MIL,2024-02-23,112,@,MIN,W 112-107,240,41,87,.471,28,50,.560,13,37,.351,17,25,.680,112,43,98,.439,30,63,.476,13,35,.371,8,13,.615,107
1362,CHI,2024-02-22,112,,BOS,L 112-129,240,44,94,.468,34,66,.515,10,28,.357,14,16,.875,112,45,83,.542,22,36,.611,23,47,.489,16,21,.762,129
1363,MIL,2024-02-12,112,,DEN,W 112-95,240,42,84,.500,26,50,.520,16,34,.471,12,18,.667,112,36,94,.383,25,54,.463,11,40,.275,12,17,.706,95
1364,DAL,2024-02-12,112,,WAS,W 112-104,240,43,96,.448,34,60,.567,9,36,.250,17,26,.654,112,44,106,.415,37,74,.500,7,32,.219,9,15,.600,104
1365,PHO,2024-02-10,112,@,GSW,L 112-113,240,43,94,.457,32,60,.533,11,34,.324,15,16,.938,112,45,101,.446,28,60,.467,17,41,.415,6,11,.545,113
1366,LAC,2024-02-10,112,,DET,W 112-106,240,37,82,.451,24,43,.558,13,39,.333,25,26,.962,112,45,102,.441,36,72,.500,9,30,.300,7,7,1.000,106
1367,DEN,2024-02-04,112,,POR,W 112-103,240,42,86,.488,30,58,.517,12,28,.429,16,19,.842,112,39,85,.459,28,54,.519,11,31,.355,14,15,.933,103
1368,WAS,2024-02-04,112,,PHO,L 112-140,240,47,96,.490,40,64,.625,7,32,.219,11,17,.647,112,54,88,.614,43,63,.683,11,25,.440,21,26,.808,140
1369,NOP,2024-01-29,112,@,BOS,L 112-118,240,46,91,.505,36,56,.643,10,35,.286,10,13,.769,112,43,85,.506,26,39,.667,17,46,.370,15,20,.750,118
1370,MIN,2024-01-27,112,@,SAS,L 112-113,240,45,79,.570,31,53,.585,14,26,.538,8,15,.533,112,46,84,.548,33,54,.611,13,30,.433,8,15,.533,113
1371,CLE,2024-01-26,112,@,MIL,W 112-100,240,38,92,.413,24,56,.429,14,36,.389,22,31,.710,112,35,87,.402,22,53,.415,13,34,.382,17,24,.708,100
1372,ATL,2024-01-24,112,@,GSW,L 112-134,240,39,94,.415,25,51,.490,14,43,.326,20,26,.769,112,51,91,.560,35,58,.603,16,33,.485,16,22,.727,134
1373,LAL,2024-01-19,112,,BRK,L 112-130,240,40,90,.444,28,57,.491,12,33,.364,20,24,.833,112,50,95,.526,31,48,.646,19,47,.404,11,14,.786,130
1374,CHO,2024-01-17,112,@,NOP,L 112-132,240,39,90,.433,20,45,.444,19,45,.422,15,18,.833,112,44,88,.500,19,41,.463,25,47,.532,19,23,.826,132
1375,LAL,2024-01-15,112,,OKC,W 112-105,240,44,84,.524,36,60,.600,8,24,.333,16,18,.889,112,40,96,.417,25,47,.532,15,49,.306,10,11,.909,105
1376,OKC,2024-01-13,112,,ORL,W 112-100,240,43,94,.457,35,58,.603,8,36,.222,18,21,.857,112,39,84,.464,32,49,.653,7,35,.200,15,24,.625,100
1377,PHI,2024-01-12,112,,SAC,W 112-93,240,40,93,.430,25,58,.431,15,35,.429,17,18,.944,112,32,95,.337,24,57,.421,8,38,.211,21,26,.808,93
1378,HOU,2024-01-12,112,@,DET,W 112-110,240,41,90,.456,33,60,.550,8,30,.267,22,25,.880,112,44,88,.500,32,53,.604,12,35,.343,10,16,.625,110
1379,IND,2024-01-10,112,,WAS,W 112-104,240,41,92,.446,33,67,.493,8,25,.320,22,24,.917,112,38,88,.432,31,57,.544,7,31,.226,21,30,.700,104
1380,NYK,2024-01-09,112,,POR,W 112-84,240,37,89,.416,19,41,.463,18,48,.375,20,23,.870,112,33,86,.384,27,57,.474,6,29,.207,12,18,.667,84
1381,CHO,2024-01-08,112,,CHI,L 112-119 (OT),265,40,94,.426,23,52,.442,17,42,.405,15,17,.882,112,45,92,.489,36,66,.545,9,26,.346,20,24,.833,119
1382,HOU,2024-01-06,112,,MIL,W 112-108,240,36,83,.434,23,49,.469,13,34,.382,27,32,.844,112,35,76,.461,26,42,.619,9,34,.265,29,42,.690,108
1383,HOU,2024-01-03,112,,BRK,W 112-101,240,37,76,.487,18,37,.486,19,39,.487,19,27,.704,112,36,93,.387,23,49,.469,13,44,.295,16,26,.615,101
1384,NOP,2024-01-02,112,,BRK,W 112-85,240,41,88,.466,25,49,.510,16,39,.410,14,18,.778,112,35,98,.357,24,55,.436,11,43,.256,4,8,.500,85
1385,NYK,2024-01-01,112,,MIN,W 112-106,240,39,89,.438,27,55,.491,12,34,.353,22,28,.786,112,36,76,.474,25,48,.521,11,28,.393,23,29,.793,106
1386,PHO,2023-12-31,112,,ORL,W 112-107,240,44,88,.500,36,61,.590,8,27,.296,16,19,.842,112,42,90,.467,30,53,.566,12,37,.324,11,12,.917,107
1387,NOP,2023-12-28,112,,UTA,W 112-105,240,45,82,.549,35,55,.636,10,27,.370,12,15,.800,112,36,85,.424,24,46,.522,12,39,.308,21,25,.840,105
1388,CHO,2023-12-28,112,@,LAL,L 112-133,240,40,85,.471,25,52,.481,15,33,.455,17,28,.607,112,52,97,.536,37,67,.552,15,30,.500,14,14,1.000,133
1389,PHI,2023-12-27,112,@,ORL,W 112-92,240,45,96,.469,35,68,.515,10,28,.357,12,17,.706,112,31,79,.392,22,46,.478,9,33,.273,21,24,.875,92
1390,DET,2023-12-26,112,,BRK,L 112-118,240,40,90,.444,31,65,.477,9,25,.360,23,32,.719,112,41,82,.500,32,60,.533,9,22,.409,27,43,.628,118
1391,MIN,2023-12-18,112,@,MIA,W 112-108,240,42,85,.494,31,56,.554,11,29,.379,17,19,.895,112,41,87,.471,30,57,.526,11,30,.367,15,18,.833,108
1392,PHO,2023-12-17,112,,WAS,W 112-108,240,41,90,.456,34,59,.576,7,31,.226,23,30,.767,112,39,95,.411,25,49,.510,14,46,.304,16,20,.800,108
1393,NOP,2023-12-15,112,@,CHO,W 112-107,240,38,80,.475,29,53,.547,9,27,.333,27,32,.844,112,41,92,.446,32,61,.525,9,31,.290,16,21,.762,107
1394,PHO,2023-12-13,112,,BRK,L 112-116,240,40,84,.476,31,56,.554,9,28,.321,23,27,.852,112,41,89,.461,26,48,.542,15,41,.366,19,24,.792,116
1395,SAS,2023-12-08,112,,CHI,L 112-121,240,39,83,.470,22,41,.537,17,42,.405,17,20,.850,112,47,102,.461,34,74,.459,13,28,.464,14,24,.583,121
1396,POR,2023-12-08,112,,DAL,L 112-125,240,39,105,.371,21,52,.404,18,53,.340,16,18,.889,112,47,91,.516,35,52,.673,12,39,.308,19,22,.864,125
1397,MIA,2023-12-06,112,@,TOR,W 112-103,240,41,89,.461,27,51,.529,14,38,.368,16,19,.842,112,37,86,.430,23,49,.469,14,37,.378,15,17,.882,103
1398,BOS,2023-12-04,112,@,IND,L 112-122,240,46,97,.474,34,56,.607,12,41,.293,8,12,.667,112,43,94,.457,24,54,.444,19,40,.475,17,21,.810,122
1399,GSW,2023-12-02,112,@,LAC,L 112-113,240,38,86,.442,21,43,.488,17,43,.395,19,24,.792,112,44,90,.489,31,51,.608,13,39,.333,12,14,.857,113
1400,DET,2023-11-30,112,@,NYK,L 112-118,240,43,81,.531,28,46,.609,15,35,.429,11,17,.647,112,41,88,.466,25,47,.532,16,41,.390,20,28,.714,118
1401,TOR,2023-11-29,112,,PHO,W 112-105,240,42,93,.452,32,66,.485,10,27,.370,18,21,.857,112,38,94,.404,31,68,.456,7,26,.269,22,23,.957,105
1402,NOP,2023-11-27,112,@,UTA,L 112-114,240,44,88,.500,37,66,.561,7,22,.318,17,25,.680,112,37,88,.420,20,40,.500,17,48,.354,23,28,.821,114
1403,BRK,2023-11-25,112,,MIA,W 112-97,240,39,78,.500,25,42,.595,14,36,.389,20,23,.870,112,38,87,.437,27,53,.509,11,34,.324,10,13,.769,97
1404,SAS,2023-11-24,112,@,GSW,L 112-118,240,45,100,.450,33,53,.623,12,47,.255,10,12,.833,112,40,81,.494,21,39,.538,19,42,.452,19,24,.792,118
1405,MIN,2023-11-22,112,,PHI,W 112-99,240,43,89,.483,33,63,.524,10,26,.385,16,24,.667,112,34,87,.391,27,55,.491,7,32,.219,24,30,.800,99
1406,SAC,2023-11-22,112,@,NOP,L 112-117,240,34,76,.447,19,32,.594,15,44,.341,29,35,.829,112,41,87,.471,34,57,.596,7,30,.233,28,37,.757,117
1407,TOR,2023-11-15,112,,MIL,L 112-128,240,38,96,.396,29,63,.460,9,33,.273,27,31,.871,112,44,85,.518,24,46,.522,20,39,.513,20,21,.952,128
1408,ORL,2023-11-11,112,,MIL,W 112-97,240,36,84,.429,26,58,.448,10,26,.385,30,35,.857,112,38,77,.494,29,48,.604,9,29,.310,12,25,.480,97
1409,MEM,2023-11-05,112,@,POR,W 112-100,240,45,89,.506,32,57,.561,13,32,.406,9,13,.692,112,37,95,.389,23,50,.460,14,45,.311,12,15,.800,100
1410,PHI,2023-11-04,112,,PHO,W 112-100,240,43,90,.478,32,60,.533,11,30,.367,15,18,.833,112,32,89,.360,23,54,.426,9,35,.257,27,33,.818,100
1411,CHI,2023-10-30,112,@,IND,W 112-105,240,40,87,.460,34,70,.486,6,17,.353,26,31,.839,112,36,88,.409,24,42,.571,12,46,.261,21,25,.840,105
1412,DET,2023-10-30,112,@,OKC,L 112-124,240,39,91,.429,24,63,.381,15,28,.536,19,24,.792,112,44,83,.530,31,54,.574,13,29,.448,23,28,.821,124
1413,MEM,2024-04-14,111,,DEN,L 111-126,240,45,100,.450,37,67,.552,8,33,.242,13,18,.722,111,46,89,.517,34,53,.642,12,36,.333,22,26,.846,126
1414,NYK,2024-04-12,111,,BRK,W 111-107,240,38,83,.458,24,53,.453,14,30,.467,21,25,.840,111,41,82,.500,30,50,.600,11,32,.344,14,19,.737,107
1415,DAL,2024-04-10,111,@,MIA,W 111-92,240,43,87,.494,28,43,.651,15,44,.341,10,13,.769,111,33,81,.407,20,51,.392,13,30,.433,13,13,1.000,92
1416,ATL,2024-04-09,111,,MIA,L 111-117 (2OT),290,45,113,.398,35,67,.522,10,46,.217,11,14,.786,111,42,88,.477,24,43,.558,18,45,.400,15,21,.714,117
1417,DEN,2024-04-09,111,@,UTA,W 111-95,240,46,94,.489,32,57,.561,14,37,.378,5,11,.455,111,36,91,.396,26,60,.433,10,31,.323,13,13,1.000,95
1418,SAS,2024-04-05,111,@,NOP,W 111-109,240,42,83,.506,25,37,.676,17,46,.370,10,13,.769,111,44,86,.512,35,57,.614,9,29,.310,12,12,1.000,109
1419,MIL,2024-04-05,111,,TOR,L 111-117,240,41,94,.436,29,52,.558,12,42,.286,17,21,.810,111,36,79,.456,22,43,.512,14,36,.389,31,36,.861,117
1420,IND,2024-04-03,111,@,BRK,L 111-115,240,46,103,.447,36,65,.554,10,38,.263,9,11,.818,111,42,87,.483,30,55,.545,12,32,.375,19,27,.704,115
1421,MEM,2024-04-03,111,@,MIL,W 111-101,240,46,91,.505,39,68,.574,7,23,.304,12,17,.706,111,38,95,.400,20,51,.392,18,44,.409,7,12,.583,101
1422,TOR,2024-04-02,111,,LAL,L 111-128,240,43,89,.483,33,57,.579,10,32,.313,15,21,.714,111,52,101,.515,34,60,.567,18,41,.439,6,12,.500,128
1423,NOP,2024-04-01,111,,PHO,L 111-124,240,42,89,.472,31,62,.500,11,27,.407,16,24,.667,111,43,87,.494,25,40,.625,18,47,.383,20,25,.800,124
1424,BRK,2024-04-01,111,@,IND,L 111-133,240,41,87,.471,31,61,.508,10,26,.385,19,28,.679,111,53,103,.515,40,72,.556,13,31,.419,14,17,.824,133
1425,MIN,2024-03-29,111,@,DEN,W 111-98,240,38,74,.514,29,46,.630,9,28,.321,26,37,.703,111,35,88,.398,27,60,.450,8,28,.286,20,27,.741,98
1426,CLE,2024-03-27,111,@,CHO,L 111-118,240,42,85,.494,23,41,.561,19,44,.432,8,14,.571,111,44,76,.579,31,43,.721,13,33,.394,17,22,.773,118
1427,UTA,2024-03-27,111,,SAS,L 111-118,240,39,83,.470,26,48,.542,13,35,.371,20,22,.909,111,44,86,.512,28,53,.528,16,33,.485,14,21,.667,118
1428,POR,2024-03-23,111,,DEN,L 111-114,240,43,93,.462,33,65,.508,10,28,.357,15,17,.882,111,41,91,.451,33,67,.493,8,24,.333,24,33,.727,114
1429,NOP,2024-03-22,111,@,MIA,W 111-88,240,42,82,.512,24,46,.522,18,36,.500,9,12,.750,111,31,86,.360,18,39,.462,13,47,.277,13,15,.867,88
1430,GSW,2024-03-22,111,,IND,L 111-123,240,43,106,.406,29,58,.500,14,48,.292,11,16,.688,111,48,99,.485,33,63,.524,15,36,.417,12,16,.750,123
1431,MEM,2024-03-18,111,@,SAC,L 111-121 (OT),265,37,98,.378,24,60,.400,13,38,.342,24,30,.800,111,42,94,.447,31,59,.525,11,35,.314,26,32,.813,121
1432,ORL,2024-03-17,111,,TOR,W 111-96,240,43,85,.506,32,49,.653,11,36,.306,14,20,.700,111,37,84,.440,29,53,.547,8,31,.258,14,15,.933,96
1433,CHI,2024-03-14,111,,LAC,L 111-126,240,41,86,.477,25,51,.490,16,35,.457,13,16,.813,111,48,80,.600,28,40,.700,20,40,.500,10,14,.714,126
1434,OKC,2024-03-12,111,,IND,L 111-121,240,43,99,.434,29,62,.468,14,37,.378,11,15,.733,111,48,89,.539,39,61,.639,9,28,.321,16,19,.842,121
1435,CLE,2024-03-11,111,,PHO,L 111-117,240,40,84,.476,25,38,.658,15,46,.326,16,19,.842,111,46,84,.548,34,52,.654,12,32,.375,13,19,.684,117
1436,IND,2024-03-10,111,@,ORL,W 111-97,240,38,78,.487,30,55,.545,8,23,.348,27,33,.818,111,33,88,.375,24,52,.462,9,36,.250,22,29,.759,97
1437,IND,2024-03-07,111,,MIN,L 111-113,240,42,82,.512,32,56,.571,10,26,.385,17,23,.739,111,46,98,.469,39,73,.534,7,25,.280,14,19,.737,113
1438,TOR,2024-03-03,111,,CHO,W 111-106,240,42,91,.462,29,53,.547,13,38,.342,14,18,.778,111,43,92,.467,35,65,.538,8,27,.296,12,16,.750,106
1439,MIL,2024-02-29,111,@,CHO,W 111-99,240,39,86,.453,23,47,.489,16,39,.410,17,20,.850,111,36,82,.439,24,43,.558,12,39,.308,15,20,.750,99
1440,BRK,2024-02-26,111,@,MEM,W 111-86,240,44,90,.489,29,48,.604,15,42,.357,8,14,.571,111,29,75,.387,22,49,.449,7,26,.269,21,26,.808,86
1441,DET,2024-02-26,111,@,NYK,L 111-113,240,38,79,.481,24,49,.490,14,30,.467,21,26,.808,111,41,92,.446,26,53,.491,15,39,.385,16,21,.762,113
1442,DAL,2024-02-25,111,@,IND,L 111-133,240,41,87,.471,27,56,.482,14,31,.452,15,21,.714,111,52,93,.559,38,57,.667,14,36,.389,15,17,.882,133
1443,DET,2024-02-13,111,@,LAL,L 111-125,240,45,108,.417,37,80,.463,8,28,.286,13,17,.765,111,43,84,.512,29,49,.592,14,35,.400,25,30,.833,125
1444,CHO,2024-02-12,111,,IND,W 111-102,240,44,82,.537,34,48,.708,10,34,.294,13,16,.813,111,42,83,.506,34,53,.642,8,30,.267,10,16,.625,102
1445,NYK,2024-02-10,111,,IND,L 111-125,240,40,84,.476,30,52,.577,10,32,.313,21,23,.913,111,50,82,.610,36,53,.679,14,29,.483,11,19,.579,125
1446,OKC,2024-02-10,111,@,DAL,L 111-146,240,38,98,.388,21,51,.412,17,47,.362,18,21,.857,111,53,91,.582,38,53,.717,15,38,.395,25,33,.758,146
1447,SAS,2024-02-08,111,@,ORL,L 111-127,240,42,81,.519,31,46,.674,11,35,.314,16,17,.941,111,49,82,.598,33,55,.600,16,27,.593,13,20,.650,127
1448,ORL,2024-02-04,111,@,DET,W 111-99,240,45,84,.536,35,60,.583,10,24,.417,11,15,.733,111,36,80,.450,28,49,.571,8,31,.258,19,22,.864,99
1449,MIN,2024-02-04,111,,HOU,W 111-90,240,40,90,.444,29,60,.483,11,30,.367,20,27,.741,111,31,88,.352,21,58,.362,10,30,.333,18,27,.667,90
1450,DEN,2024-01-27,111,,PHI,W 111-105,240,37,82,.451,24,45,.533,13,37,.351,24,38,.632,111,43,81,.531,37,59,.627,6,22,.273,13,16,.813,105
1451,OKC,2024-01-23,111,,POR,W 111-109,240,43,89,.483,36,66,.545,7,23,.304,18,28,.643,111,37,86,.430,19,47,.404,18,39,.462,17,21,.810,109
1452,CLE,2024-01-11,111,,BRK,W 111-102,240,32,82,.390,19,38,.500,13,44,.295,34,43,.791,111,37,82,.451,29,55,.527,8,27,.296,20,28,.714,102
1453,DEN,2024-01-10,111,@,UTA,L 111-124,240,37,81,.457,24,48,.500,13,33,.394,24,28,.857,111,46,83,.554,33,50,.660,13,33,.394,19,23,.826,124
1454,PHO,2024-01-08,111,@,LAC,L 111-138,240,38,77,.494,28,47,.596,10,30,.333,25,29,.862,111,53,85,.624,38,56,.679,15,29,.517,17,23,.739,138
1455,LAC,2024-01-05,111,@,NOP,W 111-95,240,40,82,.488,25,46,.543,15,36,.417,16,20,.800,111,33,92,.359,21,63,.333,12,29,.414,17,23,.739,95
1456,MEM,2024-01-03,111,,TOR,L 111-116,240,40,94,.426,25,52,.481,15,42,.357,16,19,.842,111,41,85,.482,29,59,.492,12,26,.462,22,27,.815,116
1457,CHO,2024-01-02,111,@,SAC,W 111-104,240,42,82,.512,30,48,.625,12,34,.353,15,19,.789,111,40,92,.435,26,56,.464,14,36,.389,10,17,.588,104
1458,DEN,2024-01-01,111,,CHO,W 111-93,240,41,83,.494,26,45,.578,15,38,.395,14,18,.778,111,36,86,.419,26,60,.433,10,26,.385,11,16,.688,93
1459,CLE,2023-12-29,111,,MIL,L 111-119,240,49,103,.476,43,60,.717,6,43,.140,7,9,.778,111,41,80,.513,29,51,.569,12,29,.414,25,28,.893,119
1460,NYK,2023-12-23,111,,MIL,L 111-130,240,41,93,.441,32,64,.500,9,29,.310,20,21,.952,111,48,91,.527,32,59,.542,16,32,.500,18,23,.783,130
1461,TOR,2023-12-22,111,@,PHI,L 111-121,240,39,87,.448,30,54,.556,9,33,.273,24,28,.857,111,44,83,.530,30,52,.577,14,31,.452,19,21,.905,121
1462,LAL,2023-12-21,111,@,MIN,L 111-118,240,41,83,.494,31,59,.525,10,24,.417,19,24,.792,111,42,87,.483,28,51,.549,14,36,.389,20,25,.800,118
1463,DET,2023-12-21,111,,UTA,L 111-119,240,43,86,.500,34,55,.618,9,31,.290,16,19,.842,111,43,94,.457,32,64,.500,11,30,.367,22,24,.917,119
1464,DAL,2023-12-20,111,,LAC,L 111-120,240,39,91,.429,25,48,.521,14,43,.326,19,27,.704,111,43,77,.558,32,46,.696,11,31,.355,23,25,.920,120
1465,ORL,2023-12-15,111,@,BOS,L 111-128,240,42,87,.483,28,52,.538,14,35,.400,13,18,.722,111,48,92,.522,30,50,.600,18,42,.429,14,20,.700,128
1466,DET,2023-12-13,111,,PHI,L 111-129,240,39,88,.443,29,55,.527,10,33,.303,23,30,.767,111,45,87,.517,34,57,.596,11,30,.367,28,34,.824,129
1467,CLE,2023-12-08,111,@,MIA,W 111-99,240,40,87,.460,26,49,.531,14,38,.368,17,26,.654,111,37,86,.430,22,44,.500,15,42,.357,10,15,.667,99
1468,ORL,2023-12-06,111,@,CLE,L 111-121,240,41,84,.488,39,61,.639,2,23,.087,27,37,.730,111,46,86,.535,32,52,.615,14,34,.412,15,20,.750,121
1469,LAC,2023-12-06,111,,DEN,W 111-102,240,40,87,.460,28,60,.467,12,27,.444,19,25,.760,111,41,98,.418,29,67,.433,12,31,.387,8,9,.889,102
1470,CHI,2023-12-06,111,,CHO,W 111-100,240,38,90,.422,26,65,.400,12,25,.480,23,29,.793,111,39,90,.433,29,53,.547,10,37,.270,12,12,1.000,100
1471,PHO,2023-12-01,111,,DEN,L 111-119,240,39,84,.464,30,57,.526,9,27,.333,24,26,.923,111,50,88,.568,38,56,.679,12,32,.375,7,12,.583,119
1472,MIN,2023-11-24,111,,SAC,L 111-124,240,36,82,.439,24,49,.490,12,33,.364,27,29,.931,111,49,100,.490,32,65,.492,17,35,.486,9,11,.818,124
1473,HOU,2023-11-22,111,,MEM,W 111-91,240,40,92,.435,26,49,.531,14,43,.326,17,20,.850,111,27,82,.329,20,50,.400,7,32,.219,30,35,.857,91
1474,MIA,2023-11-14,111,@,CHO,W 111-105,240,40,83,.482,32,52,.615,8,31,.258,23,28,.821,111,36,81,.444,21,49,.429,15,32,.469,18,22,.818,105
1475,DEN,2023-11-14,111,,LAC,W 111-108,240,39,73,.534,31,50,.620,8,23,.348,25,32,.781,111,37,86,.430,24,57,.421,13,29,.448,21,24,.875,108
1476,TOR,2023-11-13,111,,WAS,W 111-107,240,45,90,.500,41,70,.586,4,20,.200,17,25,.680,111,43,84,.512,31,58,.534,12,26,.462,9,12,.750,107
1477,OKC,2023-11-12,111,@,PHO,W 111-99,240,40,82,.488,30,55,.545,10,27,.370,21,25,.840,111,32,83,.386,23,54,.426,9,29,.310,26,31,.839,99
1478,SAS,2023-11-06,111,@,IND,L 111-152,240,40,94,.426,32,68,.471,8,26,.308,23,30,.767,111,55,95,.579,35,57,.614,20,38,.526,22,23,.957,152
1479,NYK,2023-11-06,111,,LAC,W 111-97,240,41,88,.466,29,57,.509,12,31,.387,17,18,.944,111,36,73,.493,25,41,.610,11,32,.344,14,16,.875,97
1480,MIL,2023-11-01,111,@,TOR,L 111-130,240,35,76,.461,22,42,.524,13,34,.382,28,38,.737,111,51,91,.560,36,53,.679,15,38,.395,13,14,.929,130
1481,DET,2023-10-27,111,@,CHO,W 111-99,240,40,88,.455,30,58,.517,10,30,.333,21,25,.840,111,33,88,.375,26,60,.433,7,28,.250,26,34,.765,99
1482,MIA,2023-10-27,111,@,BOS,L 111-119,240,38,89,.427,22,56,.393,16,33,.485,19,23,.826,111,45,95,.474,29,56,.518,16,39,.410,13,19,.684,119
1483,POR,2023-10-25,111,@,LAC,L 111-123,240,44,93,.473,34,61,.557,10,32,.313,13,17,.765,111,47,90,.522,31,56,.554,16,34,.471,13,16,.813,123
1484,NOP,2023-10-25,111,@,MEM,W 111-104,240,40,85,.471,26,53,.491,14,32,.438,17,22,.773,111,38,91,.418,26,48,.542,12,43,.279,16,20,.800,104
1485,CLE,2024-04-14,110,,CHO,L 110-120,240,44,93,.473,28,60,.467,16,33,.485,6,9,.667,110,46,91,.505,27,51,.529,19,40,.475,9,11,.818,120
1486,UTA,2024-04-12,110,@,LAC,W 110-109,240,41,88,.466,35,53,.660,6,35,.171,22,25,.880,110,43,96,.448,33,57,.579,10,39,.256,13,19,.684,109
1487,CLE,2024-04-10,110,,MEM,W 110-98,240,37,82,.451,22,45,.489,15,37,.405,21,29,.724,110,33,84,.393,19,52,.365,14,32,.438,18,19,.947,98
1488,NOP,2024-04-09,110,@,POR,W 110-100,240,36,87,.414,25,51,.490,11,36,.306,27,29,.931,110,40,85,.471,27,47,.574,13,38,.342,7,8,.875,100
1489,UTA,2024-04-07,110,@,GSW,L 110-118,240,39,83,.470,24,48,.500,15,35,.429,17,21,.810,110,49,92,.533,35,57,.614,14,35,.400,6,6,1.000,118
1490,ATL,2024-04-06,110,@,DEN,L 110-142,240,37,87,.425,25,50,.500,12,37,.324,24,29,.828,110,53,88,.602,30,47,.638,23,41,.561,13,16,.813,142
1491,HOU,2024-04-04,110,,GSW,L 110-133,240,36,86,.419,24,46,.522,12,40,.300,26,30,.867,110,47,80,.588,30,45,.667,17,35,.486,22,25,.880,133
1492,DEN,2024-04-02,110,,SAS,W 110-105,240,43,98,.439,32,64,.500,11,34,.324,13,16,.813,110,42,105,.400,29,61,.475,13,44,.295,8,16,.500,105
1493,MEM,2024-04-01,110,@,DET,W 110-108,240,40,91,.440,29,58,.500,11,33,.333,19,23,.826,110,40,79,.506,29,51,.569,11,28,.393,17,22,.773,108
1494,HOU,2024-03-25,110,,POR,W 110-92,240,37,93,.398,25,54,.463,12,39,.308,24,25,.960,110,36,87,.414,29,54,.537,7,33,.212,13,15,.867,92
1495,GSW,2024-03-24,110,@,MIN,L 110-114,240,38,85,.447,24,49,.490,14,36,.389,20,26,.769,110,40,84,.476,19,44,.432,21,40,.525,13,18,.722,114
1496,CHI,2024-03-18,110,,POR,W 110-107,240,41,93,.441,30,60,.500,11,33,.333,17,21,.810,110,40,88,.455,32,60,.533,8,28,.286,19,25,.760,107
1497,ATL,2024-03-17,110,@,LAC,W 110-93,240,41,84,.488,24,50,.480,17,34,.500,11,12,.917,110,28,74,.378,17,38,.447,11,36,.306,26,29,.897,93
1498,CHO,2024-03-13,110,@,MEM,W 110-98,240,44,82,.537,31,46,.674,13,36,.361,9,13,.692,110,36,85,.424,20,45,.444,16,40,.400,10,11,.909,98
1499,WAS,2024-03-10,110,@,MIA,W 110-108,240,39,81,.481,23,42,.548,16,39,.410,16,22,.727,110,43,95,.453,33,62,.532,10,33,.303,12,18,.667,108
1500,CHO,2024-03-09,110,,BRK,W 110-99,240,44,81,.543,33,51,.647,11,30,.367,11,15,.733,110,36,90,.400,22,48,.458,14,42,.333,13,17,.765,99
1501,DET,2024-03-05,110,@,MIA,L 110-118,240,39,89,.438,27,47,.574,12,42,.286,20,22,.909,110,42,85,.494,28,54,.519,14,31,.452,20,23,.870,118
1502,PHO,2024-03-03,110,,OKC,L 110-118,240,40,91,.440,26,52,.500,14,39,.359,16,18,.889,110,49,102,.480,40,71,.563,9,31,.290,11,15,.733,118
1503,CLE,2024-03-01,110,@,DET,W 110-100,240,33,83,.398,15,42,.357,18,41,.439,26,30,.867,110,33,89,.371,23,53,.434,10,36,.278,24,28,.857,100
1504,DAL,2024-03-01,110,@,BOS,L 110-138,240,44,94,.468,35,60,.583,9,34,.265,13,18,.722,110,52,94,.553,31,51,.608,21,43,.488,13,13,1.000,138
1505,GSW,2024-02-29,110,@,NYK,W 110-99,240,44,98,.449,30,54,.556,14,44,.318,8,16,.500,110,35,95,.368,23,56,.411,12,39,.308,17,24,.708,99
1506,PHO,2024-02-29,110,,HOU,W 110-105,240,36,89,.404,23,52,.442,13,37,.351,25,37,.676,110,33,99,.333,22,54,.407,11,45,.244,28,31,.903,105
1507,MIN,2024-02-28,110,,MEM,W 110-101,240,39,79,.494,25,44,.568,14,35,.400,18,22,.818,110,36,93,.387,25,56,.446,11,37,.297,18,20,.900,101
1508,SAC,2024-02-26,110,,MIA,L 110-121,240,45,85,.529,32,53,.604,13,32,.406,7,12,.583,110,45,87,.517,34,57,.596,11,30,.367,20,25,.800,121
1509,HOU,2024-02-25,110,,OKC,L 110-123,240,38,93,.409,22,52,.423,16,41,.390,18,23,.783,110,46,97,.474,29,62,.468,17,35,.486,14,15,.933,123
1510,PHO,2024-02-23,110,@,HOU,L 110-114,240,38,95,.400,31,64,.484,7,31,.226,27,35,.771,110,37,93,.398,22,48,.458,15,45,.333,25,34,.735,114
1511,LAL,2024-02-22,110,@,GSW,L 110-128,240,43,88,.489,33,53,.623,10,35,.286,14,21,.667,110,50,107,.467,34,66,.515,16,41,.390,12,14,.857,128
1512,NYK,2024-02-22,110,@,PHI,W 110-96,240,38,79,.481,23,45,.511,15,34,.441,19,27,.704,110,37,84,.440,27,55,.491,10,29,.345,12,14,.857,96
1513,WAS,2024-02-22,110,@,DEN,L 110-130,240,40,104,.385,23,66,.348,17,38,.447,13,23,.565,110,56,101,.554,49,70,.700,7,31,.226,11,15,.733,130
1514,MIL,2024-02-15,110,@,MEM,L 110-113,240,42,90,.467,31,46,.674,11,44,.250,15,20,.750,110,44,83,.530,31,57,.544,13,26,.500,12,19,.632,113
1515,BRK,2024-02-13,110,,BOS,L 110-118,240,39,79,.494,24,46,.522,15,33,.455,17,26,.654,110,43,83,.518,28,46,.609,15,37,.405,17,23,.739,118
1516,BOS,2024-02-11,110,@,MIA,W 110-106,240,41,81,.506,25,42,.595,16,39,.410,12,17,.706,110,40,97,.412,28,57,.491,12,40,.300,14,15,.933,106
1517,MEM,2024-02-08,110,,CHI,L 110-118,240,42,91,.462,24,45,.533,18,46,.391,8,13,.615,110,43,79,.544,31,53,.585,12,26,.462,20,22,.909,118
1518,SAC,2024-02-05,110,@,CLE,L 110-136,240,43,93,.462,26,49,.531,17,44,.386,7,12,.583,110,51,88,.580,28,47,.596,23,41,.561,11,17,.647,136
1519,MIA,2024-02-02,110,@,WAS,W 110-102,240,38,88,.432,31,57,.544,7,31,.226,27,35,.771,110,37,90,.411,26,48,.542,11,42,.262,17,21,.810,102
1520,CHO,2024-01-31,110,,CHI,L 110-117,240,40,90,.444,24,44,.545,16,46,.348,14,17,.824,110,45,87,.517,34,58,.586,11,29,.379,16,22,.727,117
1521,NOP,2024-01-31,110,@,HOU,W 110-99,240,41,82,.500,30,48,.625,11,34,.324,17,24,.708,110,35,87,.402,22,43,.512,13,44,.295,16,17,.941,99
1522,MEM,2024-01-28,110,@,IND,L 110-116,240,38,82,.463,27,52,.519,11,30,.367,23,31,.742,110,44,90,.489,31,55,.564,13,35,.371,15,16,.938,116
1523,MIA,2024-01-25,110,,BOS,L 110-143,240,42,94,.447,26,52,.500,16,42,.381,10,13,.769,110,51,80,.638,29,40,.725,22,40,.550,19,20,.950,143
1524,DAL,2024-01-22,110,,BOS,L 110-119,240,43,97,.443,29,57,.509,14,40,.350,10,14,.714,110,41,88,.466,26,42,.619,15,46,.326,22,30,.733,119
1525,POR,2024-01-21,110,@,LAL,L 110-134,240,42,90,.467,33,61,.541,9,29,.310,17,20,.850,110,47,86,.547,34,53,.642,13,33,.394,27,29,.931,134
1526,IND,2024-01-21,110,@,PHO,L 110-117,240,41,94,.436,27,63,.429,14,31,.452,14,23,.609,110,47,82,.573,39,57,.684,8,25,.320,15,18,.833,117
1527,TOR,2024-01-18,110,,CHI,L 110-116,240,42,83,.506,32,45,.711,10,38,.263,16,20,.800,110,48,91,.527,42,67,.627,6,24,.250,14,17,.824,116
1528,DAL,2024-01-17,110,@,LAL,L 110-127,240,42,91,.462,31,51,.608,11,40,.275,15,18,.833,110,49,91,.538,37,63,.587,12,28,.429,17,24,.708,127
1529,DET,2024-01-12,110,,HOU,L 110-112,240,44,88,.500,32,53,.604,12,35,.343,10,16,.625,110,41,90,.456,33,60,.550,8,30,.267,22,25,.880,112
1530,DET,2024-01-09,110,,SAC,L 110-131,240,40,85,.471,26,48,.542,14,37,.378,16,21,.762,110,54,94,.574,41,61,.672,13,33,.394,10,14,.714,131
1531,ATL,2024-01-07,110,@,ORL,L 110-117 (OT),265,42,91,.462,33,61,.541,9,30,.300,17,29,.586,110,43,98,.439,26,57,.456,17,41,.415,14,22,.636,117
1532,MIA,2024-01-03,110,@,LAL,W 110-96,240,41,93,.441,25,51,.490,16,42,.381,12,17,.706,110,35,83,.422,31,53,.585,4,30,.133,22,24,.917,96
1533,PHI,2024-01-02,110,,CHI,W 110-97,240,38,80,.475,26,50,.520,12,30,.400,22,30,.733,110,37,96,.385,30,59,.508,7,37,.189,16,23,.696,97
1534,ATL,2023-12-29,110,,SAC,L 110-117,240,37,94,.394,22,51,.431,15,43,.349,21,25,.840,110,46,89,.517,29,44,.659,17,45,.378,8,15,.533,117
1535,WAS,2023-12-29,110,,BRK,W 110-104,240,46,91,.505,31,53,.585,15,38,.395,3,7,.429,110,39,91,.429,30,63,.476,9,28,.321,17,27,.630,104
1536,DAL,2023-12-28,110,@,MIN,L 110-118,240,40,90,.444,26,57,.456,14,33,.424,16,19,.842,110,38,74,.514,21,41,.512,17,33,.515,25,34,.735,118
1537,DAL,2023-12-27,110,,CLE,L 110-113,240,39,88,.443,29,51,.569,10,37,.270,22,26,.846,110,40,92,.435,23,49,.469,17,43,.395,16,23,.696,113
1538,MIN,2023-12-23,110,@,SAC,W 110-98,240,44,87,.506,34,54,.630,10,33,.303,12,14,.857,110,37,85,.435,29,52,.558,8,33,.242,16,21,.762,98
1539,IND,2023-12-23,110,,ORL,L 110-117,240,43,82,.524,28,48,.583,15,34,.441,9,13,.692,110,39,73,.534,33,55,.600,6,18,.333,33,41,.805,117
1540,SAS,2023-12-17,110,,NOP,L 110-146,240,40,94,.426,25,52,.481,15,42,.357,15,21,.714,110,55,98,.561,33,56,.589,22,42,.524,14,22,.636,146
1541,HOU,2023-12-06,110,,OKC,W 110-101,240,40,83,.482,25,50,.500,15,33,.455,15,22,.682,110,37,87,.425,29,58,.500,8,29,.276,19,24,.792,101
1542,GSW,2023-12-06,110,,POR,W 110-106,240,36,86,.419,26,52,.500,10,34,.294,28,33,.848,110,39,95,.411,23,49,.469,16,46,.348,12,16,.750,106
1543,CLE,2023-12-02,110,@,DET,W 110-101,240,44,89,.494,34,59,.576,10,30,.333,12,18,.667,110,39,83,.470,31,53,.585,8,30,.267,15,23,.652,101
1544,LAL,2023-11-30,110,@,OKC,L 110-133,240,36,81,.444,25,48,.521,11,33,.333,27,32,.844,110,50,94,.532,36,52,.692,14,42,.333,19,22,.864,133
1545,IND,2023-11-27,110,,POR,L 110-114,240,42,88,.477,34,55,.618,8,33,.242,18,24,.750,110,40,85,.471,31,67,.463,9,18,.500,25,31,.806,114
1546,PHO,2023-11-24,110,@,MEM,W 110-89,240,39,76,.513,28,45,.622,11,31,.355,21,28,.750,110,37,80,.463,28,47,.596,9,33,.273,6,10,.600,89
1547,DEN,2023-11-17,110,@,NOP,L 110-115,240,47,96,.490,37,56,.661,10,40,.250,6,12,.500,110,46,88,.523,34,65,.523,12,23,.522,11,21,.524,115
1548,LAL,2023-11-15,110,,SAC,L 110-125,240,42,83,.506,31,54,.574,11,29,.379,15,19,.789,110,48,96,.500,32,52,.615,16,44,.364,13,17,.765,125
1549,DAL,2023-11-14,110,@,NOP,L 110-131,240,38,90,.422,24,48,.500,14,42,.333,20,26,.769,110,49,94,.521,35,56,.625,14,38,.368,19,26,.731,131
1550,POR,2023-11-12,110,@,LAL,L 110-116,240,45,90,.500,32,53,.604,13,37,.351,7,9,.778,110,41,84,.488,37,65,.569,4,19,.211,30,37,.811,116
1551,GSW,2023-11-12,110,,MIN,L 110-116,240,37,96,.385,25,53,.472,12,43,.279,24,28,.857,110,43,82,.524,34,55,.618,9,27,.333,21,30,.700,116
1552,GSW,2023-11-11,110,,CLE,L 110-118,240,37,90,.411,24,52,.462,13,38,.342,23,30,.767,110,37,86,.430,26,56,.464,11,30,.367,33,43,.767,118
1553,SAS,2023-11-10,110,,MIN,L 110-117,240,43,92,.467,31,58,.534,12,34,.353,12,19,.632,110,43,87,.494,33,60,.550,10,27,.370,21,27,.778,117
1554,MIL,2023-11-03,110,,NYK,W 110-105,240,35,82,.427,15,43,.349,20,39,.513,20,28,.714,110,38,96,.396,28,57,.491,10,39,.256,19,25,.760,105
1555,POR,2023-11-01,110,@,DET,W 110-101,240,38,81,.469,31,61,.508,7,20,.350,27,33,.818,110,40,90,.444,29,61,.475,11,29,.379,10,11,.909,101
1556,MIN,2023-11-01,110,,DEN,W 110-89,240,38,83,.458,30,62,.484,8,21,.381,26,27,.963,110,38,96,.396,32,63,.508,6,33,.182,7,10,.700,89
1557,NOP,2023-11-01,110,@,OKC,W 110-106,240,40,102,.392,27,60,.450,13,42,.310,17,29,.586,110,38,88,.432,31,54,.574,7,34,.206,23,25,.920,106
1558,MEM,2023-10-30,110,,DAL,L 110-125,240,42,92,.457,28,55,.509,14,37,.378,12,20,.600,110,42,84,.500,19,37,.514,23,47,.489,18,24,.750,125
1559,DEN,2023-10-30,110,,UTA,W 110-102,240,47,84,.560,38,56,.679,9,28,.321,7,17,.412,110,42,98,.429,31,61,.508,11,37,.297,7,15,.467,102
1560,MIL,2023-10-29,110,,ATL,L 110-127,240,39,86,.453,23,42,.548,16,44,.364,16,20,.800,110,47,93,.505,32,56,.571,15,37,.405,18,22,.818,127
1561,ATL,2023-10-25,110,@,CHO,L 110-116,240,39,93,.419,34,64,.531,5,29,.172,27,33,.818,110,43,86,.500,32,49,.653,11,37,.297,19,26,.731,116
1562,GSW,2024-04-12,109,,NOP,L 109-114,240,40,86,.465,27,52,.519,13,34,.382,16,21,.762,109,42,90,.467,22,52,.423,20,38,.526,10,16,.625,114
1563,LAC,2024-04-12,109,,UTA,L 109-110,240,43,96,.448,33,57,.579,10,39,.256,13,19,.684,109,41,88,.466,35,53,.660,6,35,.171,22,25,.880,110
1564,MIN,2024-04-12,109,,ATL,W 109-106,240,38,79,.481,28,42,.667,10,37,.270,23,29,.793,109,40,90,.444,31,60,.517,9,30,.300,17,25,.680,106
1565,BOS,2024-04-11,109,,NYK,L 109-118,240,40,86,.465,24,44,.545,16,42,.381,13,16,.813,109,49,99,.495,35,63,.556,14,36,.389,6,10,.600,118
1566,MIL,2024-04-07,109,,NYK,L 109-122,240,35,75,.467,23,41,.561,12,34,.353,27,32,.844,109,45,92,.489,31,63,.492,14,29,.483,18,22,.818,122
1567,NOP,2024-04-05,109,,SAS,L 109-111,240,44,86,.512,35,57,.614,9,29,.310,12,12,1.000,109,42,83,.506,25,37,.676,17,46,.370,10,13,.769,111
1568,SAC,2024-04-04,109,@,NYK,L 109-120,240,42,86,.488,24,44,.545,18,42,.429,7,12,.583,109,44,80,.550,32,52,.615,12,28,.429,20,29,.690,120
1569,PHI,2024-04-04,109,@,MIA,W 109-105,240,43,92,.467,29,52,.558,14,40,.350,9,11,.818,109,39,94,.415,26,51,.510,13,43,.302,14,16,.875,105
1570,DAL,2024-04-04,109,,ATL,W 109-95,240,38,94,.404,20,45,.444,18,49,.367,15,17,.882,109,34,85,.400,21,47,.447,13,38,.342,14,21,.667,95
1571,SAC,2024-04-02,109,,LAC,W 109-95,240,39,92,.424,27,50,.540,12,42,.286,19,25,.760,109,31,76,.408,20,49,.408,11,27,.407,22,27,.815,95
1572,PHI,2024-04-02,109,,OKC,W 109-105,240,36,78,.462,22,48,.458,14,30,.467,23,25,.920,109,37,87,.425,24,48,.500,13,39,.333,18,22,.818,105
1573,MIA,2024-04-02,109,,NYK,W 109-99,240,36,74,.486,19,36,.528,17,38,.447,20,21,.952,109,35,76,.461,23,42,.548,12,34,.353,17,21,.810,99
1574,CHI,2024-03-31,109,@,MIN,W 109-101,240,42,80,.525,25,51,.490,17,29,.586,8,12,.667,109,38,81,.469,27,44,.614,11,37,.297,14,21,.667,101
1575,IND,2024-03-29,109,,LAL,W 109-90,240,43,89,.483,33,58,.569,10,31,.323,13,14,.929,109,35,86,.407,30,56,.536,5,30,.167,15,18,.833,90
1576,SAC,2024-03-23,109,@,ORL,W 109-107,240,38,87,.437,23,47,.489,15,40,.375,18,21,.857,109,42,88,.477,32,53,.604,10,35,.286,13,18,.722,107
1577,TOR,2024-03-23,109,@,WAS,L 109-112,240,40,94,.426,32,61,.525,8,33,.242,21,26,.808,109,44,92,.478,33,57,.579,11,35,.314,13,19,.684,112
1578,WAS,2024-03-21,109,,SAC,W 109-102,240,41,81,.506,31,56,.554,10,25,.400,17,23,.739,109,37,86,.430,26,47,.553,11,39,.282,17,19,.895,102
1579,PHI,2024-03-16,109,,CHO,W 109-98,240,36,81,.444,23,40,.575,13,41,.317,24,25,.960,109,37,82,.451,27,51,.529,10,31,.323,14,18,.778,98
1580,DAL,2024-03-13,109,,GSW,W 109-99,240,44,82,.537,38,55,.691,6,27,.222,15,19,.789,109,37,92,.402,28,64,.438,9,28,.321,16,19,.842,99
1581,MEM,2024-03-12,109,,WAS,W 109-97,240,42,94,.447,34,61,.557,8,33,.242,17,21,.810,109,37,82,.451,26,46,.565,11,36,.306,12,16,.750,97
1582,MIN,2024-03-10,109,@,LAL,L 109-120,240,41,97,.423,25,51,.490,16,46,.348,11,13,.846,109,44,83,.530,34,59,.576,10,24,.417,22,29,.759,120
1583,BOS,2024-03-07,109,@,DEN,L 109-115,240,41,91,.451,30,53,.566,11,38,.289,16,25,.640,109,45,90,.500,41,69,.594,4,21,.190,21,22,.955,115
1584,WAS,2024-03-06,109,,ORL,L 109-119,240,40,88,.455,28,50,.560,12,38,.316,17,20,.850,109,44,81,.543,32,55,.582,12,26,.462,19,21,.905,119
1585,PHI,2024-03-06,109,,MEM,L 109-115,240,39,102,.382,26,67,.388,13,35,.371,18,21,.857,109,41,91,.451,28,54,.519,13,37,.351,20,23,.870,115
1586,SAC,2024-03-04,109,,CHI,L 109-113,240,41,92,.446,30,55,.545,11,37,.297,16,18,.889,109,42,84,.500,31,52,.596,11,32,.344,18,22,.818,113
1587,PHO,2024-03-02,109,,HOU,L 109-118,240,39,85,.459,30,56,.536,9,29,.310,22,29,.759,109,42,96,.438,26,54,.481,16,42,.381,18,26,.692,118
1588,ATL,2024-02-25,109,,ORL,W 109-92,240,41,90,.456,29,61,.475,12,29,.414,15,17,.882,109,35,84,.417,21,46,.457,14,38,.368,8,18,.444,92
1589,SAS,2024-02-25,109,@,UTA,L 109-128,240,42,91,.462,29,60,.483,13,31,.419,12,19,.632,109,46,90,.511,29,55,.527,17,35,.486,19,22,.864,128
1590,DET,2024-02-24,109,,ORL,L 109-112,240,43,85,.506,29,54,.537,14,31,.452,9,13,.692,109,43,87,.494,31,63,.492,12,24,.500,14,21,.667,112
1591,CLE,2024-02-22,109,,ORL,L 109-116,240,39,70,.557,29,48,.604,10,22,.455,21,26,.808,109,43,84,.512,29,59,.492,14,25,.560,16,18,.889,116
1592,MIA,2024-02-14,109,@,PHI,W 109-104,240,42,88,.477,31,53,.585,11,35,.314,14,15,.933,109,41,86,.477,31,51,.608,10,35,.286,12,16,.750,104
1593,POR,2024-02-13,109,,MIN,L 109-121,240,39,87,.448,28,58,.483,11,29,.379,20,25,.800,109,39,84,.464,26,51,.510,13,33,.394,30,34,.882,121
1594,IND,2024-02-08,109,,GSW,L 109-131,240,39,81,.481,27,50,.540,12,31,.387,19,27,.704,109,52,93,.559,35,61,.574,17,32,.531,10,13,.769,131
1595,GSW,2024-02-05,109,@,BRK,W 109-98,240,43,93,.462,39,71,.549,4,22,.182,19,23,.826,109,34,89,.382,21,47,.447,13,42,.310,17,22,.773,98
1596,NYK,2024-02-01,109,,IND,W 109-105,240,41,103,.398,33,65,.508,8,38,.211,19,25,.760,109,42,93,.452,29,60,.483,13,33,.394,8,13,.615,105
1597,WAS,2024-01-31,109,,LAC,L 109-125,240,45,97,.464,36,68,.529,9,29,.310,10,15,.667,109,47,100,.470,35,70,.500,12,30,.400,19,22,.864,125
1598,MIA,2024-01-27,109,@,NYK,L 109-125,240,41,88,.466,27,51,.529,14,37,.378,13,16,.813,109,45,87,.517,28,54,.519,17,33,.515,18,26,.692,125
1599,DAL,2024-01-24,109,,PHO,L 109-132,240,41,89,.461,24,46,.522,17,43,.395,10,18,.556,109,51,85,.600,37,51,.725,14,34,.412,16,22,.727,132
1600,POR,2024-01-23,109,@,OKC,L 109-111,240,37,86,.430,19,47,.404,18,39,.462,17,21,.810,109,43,89,.483,36,66,.545,7,23,.304,18,28,.643,111
1601,POR,2024-01-23,109,@,OKC,L 109-111,240,37,86,.430,19,47,.404,18,39,.462,17,21,.810,109,43,89,.483,36,66,.545,7,23,.304,18,28,.643,111
1602,ORL,2024-01-19,109,,PHI,L 109-124,240,37,78,.474,27,55,.491,10,23,.435,25,27,.926,109,42,87,.483,29,57,.509,13,30,.433,27,29,.931,124
1603,NOP,2024-01-19,109,,PHO,L 109-123,240,41,93,.441,31,51,.608,10,42,.238,17,23,.739,109,46,93,.495,31,52,.596,15,41,.366,16,21,.762,123
1604,ATL,2024-01-19,109,@,MIA,W 109-108,240,40,87,.460,25,52,.481,15,35,.429,14,17,.824,109,38,82,.463,26,51,.510,12,31,.387,20,22,.909,108
1605,WAS,2024-01-18,109,@,NYK,L 109-113,240,41,90,.456,31,59,.525,10,31,.323,17,22,.773,109,39,86,.453,26,48,.542,13,38,.342,22,26,.846,113
1606,NYK,2024-01-17,109,,HOU,W 109-94,240,39,87,.448,26,50,.520,13,37,.351,18,22,.818,109,35,84,.417,27,54,.500,8,30,.267,16,19,.842,94
1607,CLE,2024-01-15,109,,CHI,W 109-91,240,39,95,.411,19,38,.500,20,57,.351,11,11,1.000,109,35,83,.422,26,51,.510,9,32,.281,12,16,.750,91
1608,ATL,2024-01-15,109,,SAS,W 109-99,240,40,93,.430,27,55,.491,13,38,.342,16,21,.762,109,38,95,.400,27,53,.509,11,42,.262,12,17,.706,99
1609,IND,2024-01-14,109,@,DEN,L 109-117,240,43,92,.467,35,63,.556,8,29,.276,15,22,.682,109,46,71,.648,36,51,.706,10,20,.500,15,23,.652,117
1610,MIN,2024-01-14,109,,LAC,W 109-105,240,38,67,.567,25,41,.610,13,26,.500,20,31,.645,109,36,83,.434,19,44,.432,17,39,.436,16,18,.889,105
1611,LAL,2024-01-11,109,,PHO,L 109-127,240,40,80,.500,27,46,.587,13,34,.382,16,25,.640,109,46,93,.495,32,54,.593,14,39,.359,21,23,.913,127
1612,PHI,2024-01-06,109,,UTA,L 109-120,240,42,104,.404,35,66,.530,7,38,.184,18,23,.783,109,46,80,.575,38,50,.760,8,30,.267,20,24,.833,120
1613,DET,2024-01-05,109,@,GSW,L 109-113,240,44,98,.449,31,54,.574,13,44,.295,8,10,.800,109,38,82,.463,22,44,.500,16,38,.421,21,25,.840,113
1614,PHO,2024-01-01,109,,POR,W 109-88,240,38,80,.475,27,51,.529,11,29,.379,22,33,.667,109,33,80,.413,25,50,.500,8,30,.267,14,19,.737,88
1615,LAL,2023-12-31,109,@,NOP,L 109-129,240,39,82,.476,29,50,.580,10,32,.313,21,25,.840,109,45,87,.517,28,53,.528,17,34,.500,22,27,.815,129
1616,MIA,2023-12-30,109,@,UTA,L 109-117,240,34,78,.436,25,47,.532,9,31,.290,32,40,.800,109,43,93,.462,32,52,.615,11,41,.268,20,28,.714,117
1617,CLE,2023-12-23,109,@,CHI,W 109-95,240,39,88,.443,27,43,.628,12,45,.267,19,26,.731,109,35,80,.438,27,45,.600,8,35,.229,17,19,.895,95
1618,POR,2023-12-19,109,,PHO,W 109-104,240,39,87,.448,25,59,.424,14,28,.500,17,19,.895,109,42,94,.447,37,71,.521,5,23,.217,15,21,.714,104
1619,LAL,2023-12-18,109,,NYK,L 109-114,240,42,99,.424,29,58,.500,13,41,.317,12,13,.923,109,42,88,.477,32,58,.552,10,30,.333,20,23,.870,114
1620,IND,2023-12-16,109,@,MIN,L 109-127,240,45,90,.500,39,69,.565,6,21,.286,13,16,.813,109,48,86,.558,30,56,.536,18,30,.600,13,16,.813,127
1621,MEM,2023-12-02,109,@,PHO,L 109-116,240,39,86,.453,30,55,.545,9,31,.290,22,24,.917,109,36,83,.434,27,57,.474,9,26,.346,35,43,.814,116
1622,CHI,2023-11-26,109,@,BRK,L 109-118,240,40,83,.482,28,51,.549,12,32,.375,17,22,.773,109,41,83,.494,16,30,.533,25,53,.472,11,15,.733,118
1623,LAC,2023-11-22,109,@,SAS,W 109-102,240,39,85,.459,30,57,.526,9,28,.321,22,29,.759,109,35,91,.385,24,53,.453,11,38,.289,21,23,.913,102
1624,DEN,2023-11-19,109,@,CLE,L 109-121,240,39,82,.476,25,53,.472,14,29,.483,17,23,.739,109,45,82,.549,34,55,.618,11,27,.407,20,26,.769,121
1625,GSW,2023-11-16,109,,OKC,L 109-128,240,40,98,.408,26,57,.456,14,41,.341,15,19,.789,109,44,87,.506,25,55,.455,19,32,.594,21,23,.913,128
1626,CLE,2023-11-15,109,@,POR,W 109-95,240,42,75,.560,33,45,.733,9,30,.300,16,21,.762,109,34,91,.374,21,53,.396,13,38,.342,14,16,.875,95
1627,CHI,2023-11-13,109,@,MIL,L 109-118,240,38,100,.380,24,58,.414,14,42,.333,19,21,.905,109,42,89,.472,27,42,.643,15,47,.319,19,27,.704,118
1628,ATL,2023-11-11,109,,MIA,L 109-117,240,38,87,.437,20,41,.488,18,46,.391,15,18,.833,109,41,84,.488,29,46,.630,12,38,.316,23,25,.920,117
1629,DET,2023-11-06,109,,GSW,L 109-120,240,38,80,.475,25,50,.500,13,30,.433,20,21,.952,109,46,97,.474,34,56,.607,12,41,.293,16,21,.762,120
1630,BOS,2023-11-06,109,@,MIN,L 109-114 (OT),265,36,92,.391,25,53,.472,11,39,.282,26,34,.765,109,44,85,.518,31,48,.646,13,37,.351,13,25,.520,114
1631,BRK,2023-11-03,109,@,CHI,W 109-107,240,44,96,.458,26,51,.510,18,45,.400,3,5,.600,109,43,89,.483,32,61,.525,11,28,.393,10,14,.714,107
1632,BRK,2023-11-01,109,@,MIA,W 109-105,240,37,82,.451,21,46,.457,16,36,.444,19,26,.731,109,39,91,.429,26,53,.491,13,38,.342,14,18,.778,105
1633,MEM,2023-11-01,109,@,UTA,L 109-133,240,35,96,.365,21,42,.500,14,54,.259,25,32,.781,109,47,87,.540,25,44,.568,22,43,.512,17,24,.708,133
1634,NYK,2023-10-31,109,@,CLE,W 109-91,240,38,86,.442,25,52,.481,13,34,.382,20,25,.800,109,36,92,.391,26,54,.481,10,38,.263,9,12,.750,91
1635,NOP,2024-04-14,108,,LAL,L 108-124,240,41,86,.477,26,49,.531,15,37,.405,11,14,.786,108,48,87,.552,37,58,.638,11,29,.379,17,18,.944,124
1636,PHO,2024-04-12,108,@,SAC,W 108-107,240,40,76,.526,28,44,.636,12,32,.375,16,17,.941,108,40,91,.440,26,53,.491,14,38,.368,13,14,.929,107
1637,LAC,2024-04-10,108,,PHO,L 108-124,240,44,95,.463,32,59,.542,12,36,.333,8,10,.800,108,46,95,.484,28,45,.622,18,50,.360,14,15,.933,124
1638,POR,2024-04-05,108,@,WAS,W 108-102,240,41,94,.436,32,65,.492,9,29,.310,17,24,.708,108,38,88,.432,33,55,.600,5,33,.152,21,30,.700,102
1639,MEM,2024-04-05,108,,DET,W 108-90,240,42,90,.467,32,59,.542,10,31,.323,14,16,.875,108,32,79,.405,24,49,.490,8,30,.267,18,24,.750,90
1640,DAL,2024-04-05,108,,GSW,W 108-106,240,40,84,.476,28,50,.560,12,34,.353,16,21,.762,108,41,93,.441,29,58,.500,12,35,.343,12,18,.667,106
1641,CHI,2024-04-05,108,,NYK,W 108-100,240,44,93,.473,37,70,.529,7,23,.304,13,16,.813,108,36,83,.434,26,54,.481,10,29,.345,18,24,.750,100
1642,NOP,2024-04-03,108,,ORL,L 108-117,240,36,76,.474,24,47,.511,12,29,.414,24,28,.857,108,41,80,.513,28,48,.583,13,32,.406,22,30,.733,117
1643,DET,2024-04-01,108,,MEM,L 108-110,240,40,79,.506,29,51,.569,11,28,.393,17,22,.773,108,40,91,.440,29,58,.500,11,33,.333,19,23,.826,110
1644,CHI,2024-03-29,108,@,BRK,L 108-125,240,38,75,.507,29,45,.644,9,30,.300,23,29,.793,108,43,91,.473,18,47,.383,25,44,.568,14,22,.636,125
1645,LAC,2024-03-27,108,@,PHI,W 108-107,240,40,90,.444,26,54,.481,14,36,.389,14,20,.700,108,39,82,.476,26,49,.531,13,33,.394,16,19,.842,107
1646,SAC,2024-03-25,108,,PHI,W 108-96,240,38,86,.442,28,48,.583,10,38,.263,22,28,.786,108,34,82,.415,23,48,.479,11,34,.324,17,20,.850,96
1647,BRK,2024-03-21,108,@,MIL,L 108-115,240,41,92,.446,28,48,.583,13,44,.295,13,16,.813,108,43,91,.473,27,50,.540,16,41,.390,13,15,.867,115
1648,CLE,2024-03-18,108,@,IND,W 108-103,240,38,80,.475,26,48,.542,12,32,.375,20,28,.714,108,42,91,.462,33,53,.623,9,38,.237,10,16,.625,103
1649,MIA,2024-03-15,108,@,DET,W 108-95,240,43,91,.473,36,57,.632,7,34,.206,15,21,.714,108,36,84,.429,26,46,.565,10,38,.263,13,15,.867,95
1650,MIA,2024-03-10,108,,WAS,L 108-110,240,43,95,.453,33,62,.532,10,33,.303,12,18,.667,108,39,81,.481,23,42,.548,16,39,.410,16,22,.727,110
1651,MIA,2024-03-07,108,@,DAL,L 108-114,240,40,82,.488,23,44,.523,17,38,.447,11,17,.647,108,40,87,.460,24,46,.522,16,41,.390,18,23,.783,114
1652,ORL,2024-02-27,108,,BRK,W 108-81,240,39,74,.527,30,49,.612,9,25,.360,21,25,.840,108,31,79,.392,23,48,.479,8,31,.258,11,14,.786,81
1653,CLE,2024-02-14,108,,CHI,W 108-105,240,40,83,.482,28,46,.609,12,37,.324,16,21,.762,108,38,83,.458,24,50,.480,14,33,.424,15,17,.882,105
1654,CHI,2024-02-10,108,@,ORL,L 108-114 (OT),265,43,99,.434,31,62,.500,12,37,.324,10,14,.714,108,41,88,.466,28,49,.571,13,39,.333,19,26,.731,114
1655,NYK,2024-02-08,108,,DAL,L 108-122,240,42,94,.447,28,57,.491,14,37,.378,10,11,.909,108,43,82,.524,25,40,.625,18,42,.429,18,23,.783,122
1656,MIL,2024-02-04,108,@,UTA,L 108-123,240,39,84,.464,24,43,.558,15,41,.366,15,25,.600,108,43,89,.483,26,45,.578,17,44,.386,20,24,.833,123
1657,ORL,2024-02-02,108,@,MIN,W 108-106,240,39,85,.459,30,60,.500,9,25,.360,21,26,.808,108,38,82,.463,26,44,.591,12,38,.316,18,20,.900,106
1658,POR,2024-02-02,108,@,DEN,L 108-120,240,37,80,.463,27,52,.519,10,28,.357,24,30,.800,108,46,91,.505,34,55,.618,12,36,.333,16,17,.941,120
1659,CLE,2024-02-01,108,@,MEM,W 108-101,240,41,86,.477,27,51,.529,14,35,.400,12,18,.667,108,37,90,.411,25,52,.481,12,38,.316,15,17,.882,101
1660,ORL,2024-01-31,108,@,SAS,W 108-98,240,41,86,.477,34,66,.515,7,20,.350,19,23,.826,108,36,80,.450,27,49,.551,9,31,.290,17,24,.708,98
1661,LAC,2024-01-29,108,@,CLE,L 108-118,240,38,80,.475,27,46,.587,11,34,.324,21,28,.750,108,42,86,.488,29,46,.630,13,40,.325,21,26,.808,118
1662,WAS,2024-01-25,108,,UTA,L 108-123,240,43,88,.489,36,58,.621,7,30,.233,15,20,.750,108,50,97,.515,37,66,.561,13,31,.419,10,12,.833,123
1663,NYK,2024-01-23,108,@,BRK,W 108-103,240,40,86,.465,30,57,.526,10,29,.345,18,19,.947,108,42,95,.442,27,53,.509,15,42,.357,4,5,.800,103
1664,MEM,2024-01-22,108,@,TOR,W 108-100,240,44,95,.463,31,61,.508,13,34,.382,7,12,.583,108,35,79,.443,27,56,.482,8,23,.348,22,23,.957,100
1665,MIA,2024-01-19,108,,ATL,L 108-109,240,38,82,.463,26,51,.510,12,31,.387,20,22,.909,108,40,87,.460,25,52,.481,15,35,.429,14,17,.824,109
1666,DAL,2024-01-13,108,,NOP,L 108-118,240,37,82,.451,22,41,.537,15,41,.366,19,20,.950,108,39,79,.494,27,49,.551,12,30,.400,28,37,.757,118
1667,ATL,2024-01-12,108,,IND,L 108-126,240,40,89,.449,29,59,.492,11,30,.367,17,23,.739,108,53,79,.671,42,61,.689,11,18,.611,9,12,.750,126
1668,DET,2024-01-10,108,,SAS,L 108-130,240,44,96,.458,34,64,.531,10,32,.313,10,13,.769,108,49,94,.521,40,67,.597,9,27,.333,23,27,.852,130
1669,MIN,2024-01-07,108,@,DAL,L 108-115,240,41,94,.436,28,53,.528,13,41,.317,13,21,.619,108,43,95,.453,28,55,.509,15,40,.375,14,20,.700,115
1670,MIL,2024-01-06,108,@,HOU,L 108-112,240,35,76,.461,26,42,.619,9,34,.265,29,42,.690,108,36,83,.434,23,49,.469,13,34,.382,27,32,.844,112
1671,BRK,2023-12-31,108,@,OKC,L 108-124,240,38,100,.380,26,54,.481,12,46,.261,20,31,.645,108,45,83,.542,27,50,.540,18,33,.545,16,20,.800,124
1672,MIN,2023-12-30,108,,LAL,W 108-106,240,38,76,.500,26,42,.619,12,34,.353,20,24,.833,108,37,88,.420,30,64,.469,7,24,.292,25,32,.781,106
1673,NYK,2023-12-29,108,@,ORL,L 108-117,240,38,86,.442,32,56,.571,6,30,.200,26,29,.897,108,40,89,.449,33,56,.589,7,33,.212,30,40,.750,117
1674,LAC,2023-12-23,108,,BOS,L 108-145,240,41,89,.461,30,55,.545,11,34,.324,15,15,1.000,108,49,94,.521,24,41,.585,25,53,.472,22,28,.786,145
1675,LAL,2023-12-20,108,@,CHI,L 108-124,240,42,94,.447,30,57,.526,12,37,.324,12,15,.800,108,48,88,.545,30,54,.556,18,34,.529,10,11,.909,124
1676,CHI,2023-12-18,108,@,PHI,W 108-104,240,42,89,.472,30,60,.500,12,29,.414,12,15,.800,108,38,88,.432,27,56,.482,11,32,.344,17,19,.895,104
1677,BRK,2023-12-18,108,@,UTA,L 108-125,240,39,90,.433,23,51,.451,16,39,.410,14,20,.700,108,45,91,.495,31,57,.544,14,34,.412,21,24,.875,125
1678,MIA,2023-12-18,108,,MIN,L 108-112,240,41,87,.471,30,57,.526,11,30,.367,15,18,.833,108,42,85,.494,31,56,.554,11,29,.379,17,19,.895,112
1679,WAS,2023-12-17,108,@,PHO,L 108-112,240,39,95,.411,25,49,.510,14,46,.304,16,20,.800,108,41,90,.456,34,59,.576,7,31,.226,23,30,.767,112
1680,MEM,2023-12-01,108,@,DAL,W 108-94,240,44,90,.489,33,56,.589,11,34,.324,9,11,.818,108,34,92,.370,22,53,.415,12,39,.308,14,21,.667,94
1681,MIL,2023-11-26,108,,POR,W 108-102,240,35,89,.393,21,47,.447,14,42,.333,24,32,.750,108,37,91,.407,24,59,.407,13,32,.406,15,20,.750,102
1682,WAS,2023-11-25,108,,ATL,L 108-136,240,43,88,.489,33,50,.660,10,38,.263,12,12,1.000,108,52,102,.510,34,65,.523,18,37,.486,14,20,.700,136
1683,CHI,2023-11-24,108,@,TOR,L 108-121,240,42,82,.512,30,55,.545,12,27,.444,12,19,.632,108,44,83,.530,31,44,.705,13,39,.333,20,27,.741,121
1684,CHO,2023-11-18,108,,NYK,L 108-122,240,40,82,.488,23,47,.489,17,35,.486,11,13,.846,108,46,91,.505,30,54,.556,16,37,.432,14,19,.737,122
1685,SAS,2023-11-18,108,,MEM,L 108-120,240,36,83,.434,21,43,.488,15,40,.375,21,26,.808,108,40,86,.465,29,53,.547,11,33,.333,29,36,.806,120
1686,BOS,2023-11-17,108,@,TOR,W 108-105,240,42,92,.457,26,46,.565,16,46,.348,8,9,.889,108,42,87,.483,30,54,.556,12,33,.364,9,14,.643,105
1687,CLE,2023-11-17,108,,DET,W 108-100,240,42,82,.512,33,61,.541,9,21,.429,15,21,.714,108,39,91,.429,30,56,.536,9,35,.257,13,15,.867,100
1688,LAC,2023-11-14,108,@,DEN,L 108-111,240,37,86,.430,24,57,.421,13,29,.448,21,24,.875,108,39,73,.534,31,50,.620,8,23,.348,25,32,.781,111
1689,DET,2023-11-12,108,@,CHI,L 108-119,240,38,88,.432,27,56,.482,11,32,.344,21,26,.808,108,44,91,.484,33,61,.541,11,30,.367,20,25,.800,119
1690,MIA,2023-11-08,108,@,MEM,W 108-102,240,35,77,.455,24,49,.490,11,28,.393,27,32,.844,108,35,90,.389,24,53,.453,11,37,.297,21,28,.750,102
1691,DEN,2023-11-08,108,,GSW,W 108-105,240,41,92,.446,30,57,.526,11,35,.314,15,22,.682,108,37,86,.430,26,51,.510,11,35,.314,20,26,.769,105
1692,MIA,2023-11-06,108,,LAL,W 108-107,240,41,88,.466,29,51,.569,12,37,.324,14,16,.875,108,44,81,.543,36,55,.655,8,26,.308,11,14,.786,107
1693,DEN,2023-10-27,108,@,MEM,W 108-104,240,41,88,.466,27,51,.529,14,37,.378,12,18,.667,108,37,85,.435,27,52,.519,10,33,.303,20,24,.833,104
1694,OKC,2023-10-27,108,@,CLE,W 108-105,240,40,87,.460,27,61,.443,13,26,.500,15,19,.789,108,38,92,.413,26,47,.553,12,45,.267,17,23,.739,105
1695,BOS,2023-10-25,108,@,NYK,W 108-104,240,37,77,.481,25,38,.658,12,39,.308,22,26,.846,108,36,97,.371,18,56,.321,18,41,.439,14,26,.538,104
1696,PHO,2023-10-24,108,@,GSW,W 108-104,240,42,95,.442,31,62,.500,11,33,.333,13,17,.765,108,36,101,.356,26,58,.448,10,43,.233,22,28,.786,104
1697,PHI,2024-04-14,107,,BRK,W 107-86,240,41,96,.427,27,52,.519,14,44,.318,11,15,.733,107,32,83,.386,23,49,.469,9,34,.265,13,17,.765,86
1698,MIL,2024-04-12,107,@,OKC,L 107-125,240,42,85,.494,31,55,.564,11,30,.367,12,13,.923,107,47,89,.528,34,51,.667,13,38,.342,18,20,.900,125
1699,BRK,2024-04-12,107,@,NYK,L 107-111,240,41,82,.500,30,50,.600,11,32,.344,14,19,.737,107,38,83,.458,24,53,.453,14,30,.467,21,25,.840,111
1700,DET,2024-04-12,107,@,DAL,W 107-89,240,46,95,.484,38,64,.594,8,31,.258,7,9,.778,107,36,83,.434,28,54,.519,8,29,.276,9,12,.750,89
1701,SAC,2024-04-12,107,,PHO,L 107-108,240,40,91,.440,26,53,.491,14,38,.368,13,14,.929,107,40,76,.526,28,44,.636,12,32,.375,16,17,.941,108
1702,POR,2024-04-12,107,,HOU,L 107-116,240,37,95,.389,25,60,.417,12,35,.343,21,29,.724,107,44,92,.478,33,53,.623,11,39,.282,17,20,.850,116
1703,MIN,2024-04-10,107,@,DEN,L 107-116,240,41,82,.500,28,52,.538,13,30,.433,12,21,.571,107,46,83,.554,35,58,.603,11,25,.440,13,23,.565,116
1704,SAC,2024-04-07,107,@,BRK,W 107-77,240,40,94,.426,25,46,.543,15,48,.313,12,16,.750,107,30,86,.349,23,56,.411,7,30,.233,10,13,.769,77
1705,POR,2024-04-07,107,@,BOS,L 107-124,240,40,102,.392,26,64,.406,14,38,.368,13,13,1.000,107,49,87,.563,33,49,.673,16,38,.421,10,13,.769,124
1706,HOU,2024-03-31,107,,DAL,L 107-125,240,39,92,.424,26,54,.481,13,38,.342,16,19,.842,107,48,93,.516,24,46,.522,24,47,.511,5,9,.556,125
1707,WAS,2024-03-31,107,,MIA,L 107-119,240,40,88,.455,29,50,.580,11,38,.289,16,21,.762,107,40,81,.494,26,45,.578,14,36,.389,25,29,.862,119
1708,DAL,2024-03-29,107,@,SAC,W 107-103,240,35,74,.473,20,39,.513,15,35,.429,22,33,.667,107,40,92,.435,25,60,.417,15,32,.469,8,12,.667,103
1709,NOP,2024-03-28,107,,MIL,W 107-100,240,36,91,.396,28,59,.475,8,32,.250,27,34,.794,107,38,82,.463,24,43,.558,14,39,.359,10,19,.526,100
1710,PHI,2024-03-27,107,,LAC,L 107-108,240,39,82,.476,26,49,.531,13,33,.394,16,19,.842,107,40,90,.444,26,54,.481,14,36,.389,14,20,.700,108
1711,WAS,2024-03-25,107,@,CHI,W 107-105,240,39,97,.402,25,48,.521,14,49,.286,15,18,.833,107,36,87,.414,26,52,.500,10,35,.286,23,28,.821,105
1712,LAC,2024-03-24,107,,PHI,L 107-121,240,40,83,.482,30,55,.545,10,28,.357,17,18,.944,107,48,90,.533,30,53,.566,18,37,.486,7,9,.778,121
1713,ORL,2024-03-23,107,,SAC,L 107-109,240,42,88,.477,32,53,.604,10,35,.286,13,18,.722,107,38,87,.437,23,47,.489,15,40,.375,18,21,.857,109
1714,UTA,2024-03-20,107,@,OKC,L 107-119,240,40,90,.444,30,54,.556,10,36,.278,17,18,.944,107,43,88,.489,33,54,.611,10,34,.294,23,29,.793,119
1715,MIA,2024-03-20,107,@,CLE,W 107-104,240,38,83,.458,25,47,.532,13,36,.361,18,19,.947,107,35,75,.467,20,33,.606,15,42,.357,19,22,.864,104
1716,SAS,2024-03-19,107,,DAL,L 107-113,240,39,89,.438,25,50,.500,14,39,.359,15,21,.714,107,44,91,.484,34,61,.557,10,30,.333,15,17,.882,113
1717,POR,2024-03-18,107,@,CHI,L 107-110,240,40,88,.455,32,60,.533,8,28,.286,19,25,.760,107,41,93,.441,30,60,.500,11,33,.333,17,21,.810,110
1718,DAL,2024-03-17,107,,DEN,W 107-105,240,42,100,.420,33,65,.508,9,35,.257,14,21,.667,107,37,84,.440,25,56,.446,12,28,.429,19,22,.864,105
1719,POR,2024-03-16,107,@,NOP,L 107-126,240,42,84,.500,30,51,.588,12,33,.364,11,12,.917,107,52,97,.536,39,64,.609,13,33,.394,9,10,.900,126
1720,PHO,2024-03-15,107,@,CHO,W 107-96,240,40,87,.460,29,49,.592,11,38,.289,16,20,.800,107,35,94,.372,29,57,.509,6,37,.162,20,27,.741,96
1721,LAL,2024-03-13,107,@,SAC,L 107-120,240,38,78,.487,24,46,.522,14,32,.438,17,22,.773,107,46,88,.523,27,47,.574,19,41,.463,9,12,.750,120
1722,UTA,2024-03-12,107,,BOS,L 107-123,240,41,86,.477,26,54,.481,15,32,.469,10,11,.909,107,43,92,.467,23,43,.535,20,49,.408,17,19,.895,123
1723,PHO,2024-03-09,107,,BOS,L 107-117,240,44,87,.506,35,56,.625,9,31,.290,10,16,.625,107,46,94,.489,31,55,.564,15,39,.385,10,13,.769,117
1724,OKC,2024-03-08,107,,MIA,W 107-100,240,42,89,.472,30,51,.588,12,38,.316,11,13,.846,107,38,82,.463,27,53,.509,11,29,.379,13,18,.722,100
1725,POR,2024-03-08,107,,HOU,L 107-123,240,37,89,.416,21,54,.389,16,35,.457,17,25,.680,107,45,94,.479,31,57,.544,14,37,.378,19,26,.731,123
1726,DEN,2024-03-05,107,,PHO,L 107-117 (OT),265,41,96,.427,26,56,.464,15,40,.375,10,14,.714,107,42,96,.438,27,62,.435,15,34,.441,18,22,.818,117
1727,PHI,2024-03-05,107,@,BRK,L 107-112,240,40,82,.488,28,54,.519,12,28,.429,15,19,.789,107,41,84,.488,29,54,.537,12,30,.400,18,24,.750,112
1728,NYK,2024-03-03,107,@,CLE,W 107-98,240,42,86,.488,26,47,.553,16,39,.410,7,10,.700,107,39,87,.448,22,43,.512,17,44,.386,3,8,.375,98
1729,POR,2024-03-02,107,@,MEM,W 107-100 (OT),265,39,92,.424,28,57,.491,11,35,.314,18,24,.750,107,30,83,.361,15,43,.349,15,40,.375,25,33,.758,100
1730,UTA,2024-02-29,107,@,ORL,L 107-115,240,34,80,.425,18,43,.419,16,37,.432,23,28,.821,107,42,77,.545,32,47,.681,10,30,.333,21,31,.677,115
1731,LAC,2024-02-25,107,,SAC,L 107-123,240,40,82,.488,32,55,.582,8,27,.296,19,20,.950,107,45,91,.495,30,54,.556,15,37,.405,18,22,.818,123
1732,MIN,2024-02-23,107,,MIL,L 107-112,240,43,98,.439,30,63,.476,13,35,.371,8,13,.615,107,41,87,.471,28,50,.560,13,37,.351,17,25,.680,112
1733,LAC,2024-02-22,107,@,OKC,L 107-129,240,42,93,.452,30,61,.492,12,32,.375,11,13,.846,107,50,90,.556,33,55,.600,17,35,.486,12,17,.706,129
1734,UTA,2024-02-22,107,,CHO,L 107-115,240,37,86,.430,28,47,.596,9,39,.231,24,27,.889,107,40,92,.435,20,50,.400,20,42,.476,15,22,.682,115
1735,UTA,2024-02-12,107,,GSW,L 107-129,240,41,92,.446,30,60,.500,11,32,.344,14,16,.875,107,48,100,.480,28,56,.500,20,44,.455,13,17,.765,129
1736,TOR,2024-02-09,107,,HOU,W 107-104,240,40,95,.421,30,62,.484,10,33,.303,17,19,.895,107,38,85,.447,23,47,.489,15,38,.395,13,16,.813,104
1737,BRK,2024-02-06,107,,DAL,L 107-119,240,41,91,.451,29,58,.500,12,33,.364,13,15,.867,107,46,91,.505,27,48,.563,19,43,.442,8,13,.615,119
1738,CHI,2024-01-30,107,,TOR,L 107-118,240,38,75,.507,27,43,.628,11,32,.344,20,27,.741,107,43,83,.518,29,54,.537,14,29,.483,18,20,.900,118
1739,PHI,2024-01-30,107,@,GSW,L 107-119,240,39,85,.459,26,55,.473,13,30,.433,16,21,.762,107,44,79,.557,30,47,.638,14,32,.438,17,19,.895,119
1740,MIL,2024-01-29,107,@,DEN,L 107-113,240,36,84,.429,20,44,.455,16,40,.400,19,25,.760,107,44,91,.484,40,73,.548,4,18,.222,21,24,.875,113
1741,MIN,2024-01-29,107,@,OKC,W 107-101,240,40,83,.482,26,54,.481,14,29,.483,13,15,.867,107,35,79,.443,21,44,.477,14,35,.400,17,22,.773,101
1742,TOR,2024-01-26,107,,LAC,L 107-127,240,44,96,.458,38,64,.594,6,32,.188,13,22,.591,107,48,95,.505,39,63,.619,9,32,.281,22,24,.917,127
1743,MEM,2024-01-26,107,,ORL,W 107-106,240,42,90,.467,27,49,.551,15,41,.366,8,13,.615,107,38,81,.469,29,47,.617,9,34,.265,21,29,.724,106
1744,OKC,2024-01-26,107,@,NOP,W 107-83,240,42,88,.477,32,55,.582,10,33,.303,13,14,.929,107,32,82,.390,23,46,.500,9,36,.250,10,14,.714,83
1745,WAS,2024-01-24,107,,MIN,L 107-118,240,37,77,.481,27,53,.509,10,24,.417,23,29,.793,107,42,100,.420,33,68,.485,9,32,.281,25,29,.862,118
1746,ATL,2024-01-22,107,@,SAC,L 107-122,240,36,93,.387,22,53,.415,14,40,.350,21,27,.778,107,43,93,.462,31,55,.564,12,38,.316,24,27,.889,122
1747,HOU,2024-01-21,107,,BOS,L 107-116,240,41,94,.436,31,59,.525,10,35,.286,15,22,.682,107,43,98,.439,26,51,.510,17,47,.362,13,18,.722,116
1748,GSW,2024-01-15,107,@,MEM,L 107-116,240,44,90,.489,34,59,.576,10,31,.323,9,10,.900,107,32,86,.372,12,32,.375,20,54,.370,32,40,.800,116
1749,ORL,2023-12-31,107,@,PHO,L 107-112,240,42,90,.467,30,53,.566,12,37,.324,11,12,.917,107,44,88,.500,36,61,.590,8,27,.296,16,19,.842,112
1750,CHO,2023-12-15,107,,NOP,L 107-112,240,41,92,.446,32,61,.525,9,31,.290,16,21,.762,107,38,80,.475,29,53,.547,9,27,.333,27,32,.844,112
1751,CLE,2023-12-14,107,@,BOS,L 107-116,240,40,83,.482,29,50,.580,11,33,.333,16,17,.941,107,43,85,.506,30,49,.612,13,36,.361,17,20,.850,116
1752,MIN,2023-12-11,107,@,NOP,L 107-121,240,40,91,.440,27,55,.491,13,36,.361,14,19,.737,107,40,82,.488,30,55,.545,10,27,.370,31,40,.775,121
1753,LAL,2023-12-02,107,,HOU,W 107-97,240,40,89,.449,32,62,.516,8,27,.296,19,27,.704,107,36,89,.404,25,58,.431,11,31,.355,14,18,.778,97
1754,DET,2023-11-29,107,,LAL,L 107-133,240,40,97,.412,25,61,.410,15,36,.417,12,14,.857,107,45,88,.511,33,54,.611,12,34,.353,31,38,.816,133
1755,DET,2023-11-27,107,,WAS,L 107-126,240,43,102,.422,35,64,.547,8,38,.211,13,19,.684,107,45,89,.506,35,60,.583,10,29,.345,26,28,.929,126
1756,LAC,2023-11-25,107,,DAL,W 107-88,240,38,88,.432,30,59,.508,8,29,.276,23,31,.742,107,34,91,.374,25,53,.472,9,38,.237,11,14,.786,88
1757,POR,2023-11-21,107,@,PHO,L 107-120,240,38,87,.437,24,56,.429,14,31,.452,17,20,.850,107,43,76,.566,36,59,.610,7,17,.412,27,28,.964,120
1758,TOR,2023-11-21,107,@,ORL,L 107-126,240,38,75,.507,24,47,.511,14,28,.500,17,22,.773,107,50,100,.500,38,69,.551,12,31,.387,14,20,.700,126
1759,DEN,2023-11-20,107,@,DET,W 107-103,240,40,87,.460,29,59,.492,11,28,.393,16,21,.762,107,36,81,.444,29,60,.483,7,21,.333,24,26,.923,103
1760,LAL,2023-11-17,107,@,POR,W 107-95,240,40,81,.494,28,52,.538,12,29,.414,15,22,.682,107,36,89,.404,26,52,.500,10,37,.270,13,18,.722,95
1761,PHI,2023-11-15,107,,BOS,L 107-117,240,39,85,.459,28,55,.509,11,30,.367,18,22,.818,107,42,88,.477,24,38,.632,18,50,.360,15,19,.789,117
1762,MEM,2023-11-14,107,@,LAL,L 107-134,240,39,106,.368,19,53,.358,20,53,.377,9,12,.750,107,47,81,.580,25,46,.543,22,35,.629,18,24,.750,134
1763,WAS,2023-11-13,107,@,TOR,L 107-111,240,43,84,.512,31,58,.534,12,26,.462,9,12,.750,107,45,90,.500,41,70,.586,4,20,.200,17,25,.680,111
1764,HOU,2023-11-12,107,,DEN,W 107-104,240,37,87,.425,27,55,.491,10,32,.313,23,29,.793,107,42,91,.462,33,59,.559,9,32,.281,11,14,.786,104
1765,CHO,2023-11-12,107,@,NYK,L 107-129,240,44,94,.468,32,59,.542,12,35,.343,7,11,.636,107,47,87,.540,32,51,.627,15,36,.417,20,30,.667,129
1766,BRK,2023-11-10,107,@,BOS,L 107-121,240,38,85,.447,23,48,.479,15,37,.405,16,18,.889,107,41,94,.436,22,42,.524,19,52,.365,20,28,.714,121
1767,LAL,2023-11-06,107,@,MIA,L 107-108,240,44,81,.543,36,55,.655,8,26,.308,11,14,.786,107,41,88,.466,29,51,.569,12,37,.324,14,16,.875,108
1768,HOU,2023-11-04,107,,SAC,W 107-89,240,40,87,.460,27,51,.529,13,36,.361,14,20,.700,107,32,84,.381,21,43,.488,11,41,.268,14,19,.737,89
1769,CHI,2023-11-03,107,,BRK,L 107-109,240,43,89,.483,32,61,.525,11,28,.393,10,14,.714,107,44,96,.458,26,51,.510,18,45,.400,3,5,.600,109
1770,WAS,2023-10-30,107,,BOS,L 107-126,240,39,87,.448,28,51,.549,11,36,.306,18,26,.692,107,51,102,.500,32,49,.653,19,53,.358,5,7,.714,126
1771,TOR,2023-10-28,107,,PHI,L 107-114,240,38,87,.437,21,55,.382,17,32,.531,14,19,.737,107,43,86,.500,33,58,.569,10,28,.357,18,21,.857,114
1772,LAL,2023-10-24,107,@,DEN,L 107-119,240,41,90,.456,31,61,.508,10,29,.345,15,20,.750,107,48,91,.527,34,57,.596,14,34,.412,9,12,.750,119
1773,MIN,2024-04-14,106,,PHO,L 106-125,240,36,70,.514,27,44,.614,9,26,.346,25,31,.806,106,47,86,.547,31,57,.544,16,29,.552,15,18,.833,125
1774,ATL,2024-04-12,106,@,MIN,L 106-109,240,40,90,.444,31,60,.517,9,30,.300,17,25,.680,106,38,79,.481,28,42,.667,10,37,.270,23,29,.793,109
1775,BRK,2024-04-10,106,,TOR,W 106-102,240,38,86,.442,27,50,.540,11,36,.306,19,24,.792,106,35,94,.372,19,54,.352,16,40,.400,16,18,.889,102
1776,ORL,2024-04-09,106,@,HOU,L 106-118,240,39,86,.453,32,62,.516,7,24,.292,21,23,.913,106,45,86,.523,30,51,.588,15,35,.429,13,18,.722,118
1777,GSW,2024-04-05,106,@,DAL,L 106-108,240,41,93,.441,29,58,.500,12,35,.343,12,18,.667,106,40,84,.476,28,50,.560,12,34,.353,16,21,.762,108
1778,HOU,2024-04-02,106,@,MIN,L 106-113,240,41,92,.446,27,44,.614,14,48,.292,10,14,.714,106,41,77,.532,30,51,.588,11,26,.423,20,22,.909,113
1779,UTA,2024-03-31,106,@,SAC,L 106-127,240,34,83,.410,18,42,.429,16,41,.390,22,28,.786,106,45,84,.536,25,44,.568,20,40,.500,17,23,.739,127
1780,MIN,2024-03-27,106,,DET,W 106-91,240,42,82,.512,31,46,.674,11,36,.306,11,16,.688,106,31,81,.383,22,49,.449,9,32,.281,20,25,.800,91
1781,POR,2024-03-27,106,@,ATL,L 106-120,240,43,85,.506,29,54,.537,14,31,.452,6,10,.600,106,44,85,.518,28,44,.636,16,41,.390,16,20,.800,120
1782,SAS,2024-03-23,106,,PHO,L 106-131,240,40,85,.471,31,52,.596,9,33,.273,17,21,.810,106,56,94,.596,45,70,.643,11,24,.458,8,10,.800,131
1783,NOP,2024-03-21,106,@,ORL,L 106-121,240,42,78,.538,36,58,.621,6,20,.300,16,21,.762,106,47,86,.547,33,50,.660,14,36,.389,13,19,.684,121
1784,SAS,2024-03-15,106,,DEN,L 106-117,240,37,81,.457,26,52,.500,11,29,.379,21,27,.778,106,49,89,.551,39,64,.609,10,25,.400,9,12,.750,117
1785,POR,2024-03-13,106,,ATL,W 106-102,240,38,82,.463,28,52,.538,10,30,.333,20,24,.833,106,38,88,.432,24,49,.490,14,39,.359,12,18,.667,102
1786,BRK,2024-03-13,106,@,ORL,L 106-114,240,38,81,.469,31,55,.564,7,26,.269,23,27,.852,106,40,77,.519,26,45,.578,14,32,.438,20,26,.769,114
1787,NYK,2024-03-12,106,,PHI,W 106-79,240,40,79,.506,26,39,.667,14,40,.350,12,15,.800,106,30,80,.375,22,47,.468,8,33,.242,11,16,.688,79
1788,LAC,2024-03-04,106,@,MIL,L 106-113,240,37,84,.440,21,44,.477,16,40,.400,16,25,.640,106,37,78,.474,22,40,.550,15,38,.395,24,28,.857,113
1789,MEM,2024-03-04,106,@,BRK,W 106-102,240,38,82,.463,26,45,.578,12,37,.324,18,22,.818,106,35,79,.443,20,37,.541,15,42,.357,17,30,.567,102
1790,CHO,2024-03-03,106,@,TOR,L 106-111,240,43,92,.467,35,65,.538,8,27,.296,12,16,.750,106,42,91,.462,29,53,.547,13,38,.342,14,18,.778,111
1791,MIA,2024-02-27,106,@,POR,W 106-96,240,37,70,.529,23,44,.523,14,26,.538,18,26,.692,106,35,86,.407,25,55,.455,10,31,.323,16,19,.842,96
1792,NOP,2024-02-25,106,,CHI,L 106-114,240,40,88,.455,24,47,.511,16,41,.390,10,14,.714,106,41,95,.432,28,55,.509,13,40,.325,19,21,.905,114
1793,WAS,2024-02-23,106,@,OKC,L 106-147,240,41,104,.394,32,66,.485,9,38,.237,15,21,.714,106,55,92,.598,35,52,.673,20,40,.500,17,21,.810,147
1794,MIA,2024-02-23,106,@,NOP,W 106-95,240,38,82,.463,25,53,.472,13,29,.448,17,25,.680,106,39,104,.375,32,72,.444,7,32,.219,10,13,.769,95
1795,MIA,2024-02-11,106,,BOS,L 106-110,240,40,97,.412,28,57,.491,12,40,.300,14,15,.933,106,41,81,.506,25,42,.595,16,39,.410,12,17,.706,110
1796,DET,2024-02-10,106,@,LAC,L 106-112,240,45,102,.441,36,72,.500,9,30,.300,7,7,1.000,106,37,82,.451,24,43,.558,13,39,.333,25,26,.962,112
1797,MEM,2024-02-10,106,@,CHO,L 106-115,240,43,92,.467,27,48,.563,16,44,.364,4,8,.500,106,47,82,.573,31,51,.608,16,31,.516,5,7,.714,115
1798,DEN,2024-02-09,106,@,SAC,L 106-135,240,38,82,.463,28,53,.528,10,29,.345,20,28,.714,106,51,87,.586,34,53,.642,17,34,.500,16,18,.889,135
1799,LAL,2024-02-08,106,,DEN,L 106-114,240,41,89,.461,33,64,.516,8,25,.320,16,22,.727,106,47,97,.485,33,65,.508,14,32,.438,6,7,.857,114
1800,LAC,2024-02-07,106,,NOP,L 106-117,240,36,78,.462,24,46,.522,12,32,.375,22,26,.846,106,47,88,.534,35,56,.625,12,32,.375,11,16,.688,117
1801,WAS,2024-02-07,106,,CLE,L 106-114,240,42,94,.447,26,54,.481,16,40,.400,6,9,.667,106,43,88,.489,31,53,.585,12,35,.343,16,22,.727,114
1802,MIL,2024-02-06,106,@,PHO,L 106-114,240,39,90,.433,26,50,.520,13,40,.325,15,25,.600,106,44,87,.506,36,59,.610,8,28,.286,18,27,.667,114
1803,MIN,2024-02-02,106,,ORL,L 106-108,240,38,82,.463,26,44,.591,12,38,.316,18,20,.900,106,39,85,.459,30,60,.500,9,25,.360,21,26,.808,108
1804,CHO,2024-02-02,106,@,OKC,L 106-126,240,41,92,.446,27,61,.443,14,31,.452,10,14,.714,106,44,75,.587,27,39,.692,17,36,.472,21,27,.778,126
1805,TOR,2024-02-02,106,@,HOU,L 106-135,240,40,91,.440,29,58,.500,11,33,.333,15,20,.750,106,55,93,.591,44,62,.710,11,31,.355,14,17,.824,135
1806,SAC,2024-01-31,106,@,MIA,L 106-115,240,41,93,.441,29,53,.547,12,40,.300,12,18,.667,106,42,84,.500,29,56,.518,13,28,.464,18,23,.783,115
1807,BRK,2024-01-27,106,,HOU,W 106-104,240,36,74,.486,24,40,.600,12,34,.353,22,37,.595,106,37,94,.394,27,57,.474,10,37,.270,20,23,.870,104
1808,ORL,2024-01-26,106,@,MEM,L 106-107,240,38,81,.469,29,47,.617,9,34,.265,21,29,.724,106,42,90,.467,27,49,.551,15,41,.366,8,13,.615,107
1809,CHO,2024-01-24,106,@,DET,L 106-113,240,38,87,.437,23,49,.469,15,38,.395,15,19,.789,106,43,86,.500,28,48,.583,15,38,.395,12,20,.600,113
1810,ATL,2024-01-17,106,,ORL,W 106-104,240,39,76,.513,31,51,.608,8,25,.320,20,22,.909,106,39,88,.443,29,53,.547,10,35,.286,16,22,.727,104
1811,NYK,2024-01-13,106,@,MEM,W 106-94,240,40,83,.482,27,45,.600,13,38,.342,13,19,.684,106,36,87,.414,27,49,.551,9,38,.237,13,15,.867,94
1812,LAL,2024-01-07,106,,LAC,W 106-103,240,42,82,.512,31,53,.585,11,29,.379,11,16,.688,106,36,91,.396,22,54,.407,14,37,.378,17,19,.895,103
1813,MIN,2024-01-03,106,,NOP,L 106-117,240,37,82,.451,27,51,.529,10,31,.323,22,27,.815,106,45,81,.556,33,55,.600,12,26,.462,15,17,.882,117
1814,MEM,2024-01-02,106,,SAS,W 106-98,240,37,80,.463,25,42,.595,12,38,.316,20,25,.800,106,36,85,.424,26,54,.481,10,31,.323,16,23,.696,98
1815,MIN,2024-01-01,106,@,NYK,L 106-112,240,36,76,.474,25,48,.521,11,28,.393,23,29,.793,106,39,89,.438,27,55,.491,12,34,.353,22,28,.786,112
1816,LAL,2023-12-30,106,@,MIN,L 106-108,240,37,88,.420,30,64,.469,7,24,.292,25,32,.781,106,38,76,.500,26,42,.619,12,34,.353,20,24,.833,108
1817,MEM,2023-12-29,106,@,LAC,L 106-117,240,38,87,.437,25,47,.532,13,40,.325,17,20,.850,106,43,87,.494,32,48,.667,11,39,.282,20,25,.800,117
1818,MIN,2023-12-26,106,@,OKC,L 106-129,240,34,73,.466,22,46,.478,12,27,.444,26,32,.813,106,49,81,.605,31,42,.738,18,39,.462,13,16,.813,129
1819,HOU,2023-12-23,106,@,NOP,W 106-104,240,35,82,.427,26,53,.491,9,29,.310,27,35,.771,106,38,82,.463,30,51,.588,8,31,.258,20,29,.690,104
1820,POR,2023-12-23,106,@,GSW,L 106-126,240,38,84,.452,25,49,.510,13,35,.371,17,25,.680,106,48,83,.578,38,50,.760,10,33,.303,20,24,.833,126
1821,ORL,2023-12-20,106,,MIA,L 106-115,240,41,89,.461,32,53,.604,9,36,.250,15,19,.789,106,40,83,.482,25,54,.463,15,29,.517,20,24,.833,115
1822,CHI,2023-12-12,106,,DEN,L 106-114,240,36,86,.419,23,46,.500,13,40,.325,21,23,.913,106,39,83,.470,25,53,.472,14,30,.467,22,32,.688,114
1823,PHO,2023-12-08,106,,SAC,L 106-114,240,40,83,.482,29,51,.569,11,32,.344,15,23,.652,106,42,92,.457,28,53,.528,14,39,.359,16,20,.800,114
1824,DEN,2023-12-08,106,,HOU,L 106-114,240,38,90,.422,28,62,.452,10,28,.357,20,27,.741,106,35,82,.427,22,43,.512,13,39,.333,31,42,.738,114
1825,POR,2023-12-06,106,@,GSW,L 106-110,240,39,95,.411,23,49,.469,16,46,.348,12,16,.750,106,36,86,.419,26,52,.500,10,34,.294,28,33,.848,110
1826,LAL,2023-12-05,106,,PHO,W 106-103,240,38,102,.373,29,72,.403,9,30,.300,21,25,.840,106,37,75,.493,25,50,.500,12,25,.480,17,21,.810,103
1827,TOR,2023-12-01,106,,NYK,L 106-119,240,44,100,.440,38,68,.559,6,32,.188,12,17,.706,106,45,90,.500,29,54,.537,16,36,.444,13,16,.813,119
1828,SAS,2023-12-01,106,@,NOP,L 106-121,240,38,83,.458,22,44,.500,16,39,.410,14,17,.824,106,42,85,.494,32,54,.593,10,31,.323,27,29,.931,121
1829,MIN,2023-11-28,106,,OKC,W 106-103,240,33,78,.423,19,45,.422,14,33,.424,26,32,.813,106,37,90,.411,26,60,.433,11,30,.367,18,23,.783,103
1830,LAC,2023-11-24,106,,NOP,L 106-116,240,42,92,.457,31,55,.564,11,37,.297,11,17,.647,106,43,88,.489,33,64,.516,10,24,.417,20,27,.741,116
1831,LAC,2023-11-17,106,,HOU,W 106-100,240,36,83,.434,23,49,.469,13,34,.382,21,30,.700,106,38,88,.432,28,57,.491,10,31,.323,14,20,.700,100
1832,DET,2023-11-10,106,,PHI,L 106-114,240,40,86,.465,32,58,.552,8,28,.286,18,22,.818,106,35,83,.422,26,55,.473,9,28,.321,35,41,.854,114
1833,PHI,2023-11-08,106,,BOS,W 106-103,240,42,95,.442,33,61,.541,9,34,.265,13,15,.867,106,36,91,.396,21,44,.477,15,47,.319,16,19,.842,103
1834,DET,2023-11-05,106,,PHO,L 106-120,240,43,87,.494,35,64,.547,8,23,.348,12,14,.857,106,43,86,.500,35,65,.538,8,21,.381,26,29,.897,120
1835,OKC,2023-11-01,106,,NOP,L 106-110,240,38,88,.432,31,54,.574,7,34,.206,23,25,.920,106,40,102,.392,27,60,.450,13,42,.310,17,29,.586,110
1836,LAL,2023-10-30,106,,ORL,W 106-103,240,42,79,.532,34,52,.654,8,27,.296,14,18,.778,106,38,95,.400,24,60,.400,14,35,.400,13,18,.722,103
1837,GSW,2023-10-29,106,@,HOU,W 106-95,240,35,81,.432,17,36,.472,18,45,.400,18,23,.783,106,34,90,.378,25,57,.439,9,33,.273,18,19,.947,95
1838,MEM,2023-10-28,106,@,WAS,L 106-113,240,39,91,.429,20,44,.455,19,47,.404,9,9,1.000,106,40,93,.430,24,47,.511,16,46,.348,17,22,.773,113
1839,MIN,2023-10-28,106,,MIA,W 106-90,240,44,86,.512,32,52,.615,12,34,.353,6,8,.750,106,35,87,.402,23,49,.469,12,38,.316,8,14,.571,90
1840,LAC,2024-04-14,105,,HOU,L 105-116,240,41,104,.394,33,67,.493,8,37,.216,15,17,.882,105,50,103,.485,39,65,.600,11,38,.289,5,14,.357,116
1841,DET,2024-04-11,105,,CHI,L 105-127,240,38,77,.494,24,42,.571,14,35,.400,15,23,.652,105,51,96,.531,37,60,.617,14,36,.389,11,15,.733,127
1842,SAC,2024-04-09,105,@,OKC,L 105-112,240,33,96,.344,13,38,.342,20,58,.345,19,26,.731,105,39,80,.488,28,50,.560,11,30,.367,23,31,.742,112
1843,LAC,2024-04-09,105,@,PHO,W 105-92,240,41,87,.471,29,61,.475,12,26,.462,11,11,1.000,105,30,89,.337,22,54,.407,8,35,.229,24,28,.857,92
1844,PHO,2024-04-07,105,,NOP,L 105-113,240,39,87,.448,25,48,.521,14,39,.359,13,14,.929,105,40,85,.471,24,46,.522,16,39,.410,17,19,.895,113
1845,MIA,2024-04-04,105,,PHI,L 105-109,240,39,94,.415,26,51,.510,13,43,.302,14,16,.875,105,43,92,.467,29,52,.558,14,40,.350,9,11,.818,109
1846,SAS,2024-04-02,105,@,DEN,L 105-110,240,42,105,.400,29,61,.475,13,44,.295,8,16,.500,105,43,98,.439,32,64,.500,11,34,.324,13,16,.813,110
1847,OKC,2024-04-02,105,@,PHI,L 105-109,240,37,87,.425,24,48,.500,13,39,.333,18,22,.818,105,36,78,.462,22,48,.458,14,30,.467,23,25,.920,109
1848,CHI,2024-03-25,105,,WAS,L 105-107,240,36,87,.414,26,52,.500,10,35,.286,23,28,.821,105,39,97,.402,25,48,.521,14,49,.286,15,18,.833,107
1849,UTA,2024-03-25,105,,DAL,L 105-115,240,37,87,.425,24,48,.500,13,39,.333,18,22,.818,105,44,92,.478,32,50,.640,12,42,.286,15,18,.833,115
1850,NYK,2024-03-23,105,,BRK,W 105-93,240,42,97,.433,27,57,.474,15,40,.375,6,12,.500,105,34,76,.447,22,42,.524,12,34,.353,13,15,.867,93
1851,ATL,2024-03-18,105,@,LAL,L 105-136,240,42,98,.429,33,57,.579,9,41,.220,12,15,.800,105,52,90,.578,37,54,.685,15,36,.417,17,20,.850,136
1852,DEN,2024-03-17,105,@,DAL,L 105-107,240,37,84,.440,25,56,.446,12,28,.429,19,22,.864,105,42,100,.420,33,65,.508,9,35,.257,14,21,.667,107
1853,NYK,2024-03-14,105,@,POR,W 105-93,240,38,87,.437,32,58,.552,6,29,.207,23,26,.885,105,34,84,.405,23,51,.451,11,33,.333,14,16,.875,93
1854,PHI,2024-03-14,105,@,MIL,L 105-114,240,39,79,.494,22,44,.500,17,35,.486,10,14,.714,105,39,72,.542,23,36,.639,16,36,.444,20,24,.833,114
1855,CLE,2024-03-05,105,,BOS,W 105-104,240,39,90,.433,19,48,.396,20,42,.476,7,11,.636,105,39,93,.419,24,55,.436,15,38,.395,11,12,.917,104
1856,IND,2024-03-03,105,@,SAS,L 105-117,240,41,93,.441,35,63,.556,6,30,.200,17,21,.810,105,46,85,.541,36,60,.600,10,25,.400,15,19,.789,117
1857,TOR,2024-03-01,105,,GSW,L 105-120,240,41,95,.432,29,50,.580,12,45,.267,11,17,.647,105,44,98,.449,26,54,.481,18,44,.409,14,18,.778,120
1858,HOU,2024-02-29,105,@,PHO,L 105-110,240,33,99,.333,22,54,.407,11,45,.244,28,31,.903,105,36,89,.404,23,52,.442,13,37,.351,25,37,.676,110
1859,DET,2024-02-27,105,@,CHI,W 105-95,240,37,75,.493,23,38,.605,14,37,.378,17,23,.739,105,39,98,.398,37,69,.536,2,29,.069,15,18,.833,95
1860,SAS,2024-02-27,105,@,MIN,L 105-114,240,39,82,.476,23,41,.561,16,41,.390,11,15,.733,105,43,93,.462,30,62,.484,13,31,.419,15,17,.882,114
1861,WAS,2024-02-25,105,,CLE,L 105-114,240,40,90,.444,28,50,.560,12,40,.300,13,18,.722,105,42,83,.506,32,51,.627,10,32,.313,20,27,.741,114
1862,HOU,2024-02-22,105,@,NOP,L 105-127,240,36,82,.439,21,41,.512,15,41,.366,18,28,.643,105,50,96,.521,34,55,.618,16,41,.390,11,18,.611,127
1863,CHI,2024-02-14,105,@,CLE,L 105-108,240,38,83,.458,24,50,.480,14,33,.424,15,17,.882,105,40,83,.482,28,46,.609,12,37,.324,16,21,.762,108
1864,HOU,2024-02-12,105,,NYK,W 105-103,240,36,80,.450,26,54,.481,10,26,.385,23,33,.697,105,42,92,.457,30,56,.536,12,36,.333,7,12,.583,103
1865,MIL,2024-02-08,105,,MIN,L 105-129,240,40,81,.494,26,48,.542,14,33,.424,11,16,.688,105,48,87,.552,27,46,.587,21,41,.512,12,16,.750,129
1866,NYK,2024-02-03,105,,LAL,L 105-113,240,41,100,.410,31,65,.477,10,35,.286,13,15,.867,105,39,80,.488,27,49,.551,12,31,.387,23,27,.852,113
1867,BOS,2024-02-01,105,,LAL,L 105-114,240,41,97,.423,25,49,.510,16,48,.333,7,7,1.000,105,38,94,.404,19,58,.328,19,36,.528,19,26,.731,114
1868,IND,2024-02-01,105,@,NYK,L 105-109,240,42,93,.452,29,60,.483,13,33,.394,8,13,.615,105,41,103,.398,33,65,.508,8,38,.211,19,25,.760,109
1869,OKC,2024-01-31,105,,DEN,W 105-100,240,37,87,.425,26,61,.426,11,26,.423,20,25,.800,105,37,93,.398,22,56,.393,15,37,.405,11,16,.688,100
1870,MIA,2024-01-29,105,,PHO,L 105-118,240,33,84,.393,19,48,.396,14,36,.389,25,25,1.000,105,46,94,.489,32,54,.593,14,40,.350,12,17,.706,118
1871,PHI,2024-01-27,105,@,DEN,L 105-111,240,43,81,.531,37,59,.627,6,22,.273,13,16,.813,105,37,82,.451,24,45,.533,13,37,.351,24,38,.632,111
1872,MEM,2024-01-24,105,@,MIA,W 105-96,240,36,80,.450,19,44,.432,17,36,.472,16,19,.842,105,33,82,.402,22,48,.458,11,34,.324,19,25,.760,96
1873,ORL,2024-01-21,105,,MIA,W 105-87,240,37,78,.474,28,50,.560,9,28,.321,22,28,.786,105,30,80,.375,18,43,.419,12,37,.324,15,18,.833,87
1874,POR,2024-01-17,105,,BRK,W 105-103,240,42,86,.488,33,59,.559,9,27,.333,12,14,.857,105,35,73,.479,20,35,.571,15,38,.395,18,27,.667,103
1875,IND,2024-01-15,105,@,UTA,L 105-132,240,38,95,.400,29,64,.453,9,31,.290,20,25,.800,105,45,81,.556,34,56,.607,11,25,.440,31,35,.886,132
1876,BOS,2024-01-15,105,@,TOR,W 105-96,240,33,82,.402,17,43,.395,16,39,.410,23,25,.920,105,38,95,.400,34,63,.540,4,32,.125,16,21,.762,96
1877,OKC,2024-01-15,105,@,LAL,L 105-112,240,40,96,.417,25,47,.532,15,49,.306,10,11,.909,105,44,84,.524,36,60,.600,8,24,.333,16,18,.889,112
1878,LAC,2024-01-14,105,@,MIN,L 105-109,240,36,83,.434,19,44,.432,17,39,.436,16,18,.889,105,38,67,.567,25,41,.610,13,26,.500,20,31,.645,109
1879,GSW,2024-01-10,105,,NOP,L 105-141,240,39,89,.438,27,50,.540,12,39,.308,15,18,.833,105,54,94,.574,35,54,.648,19,40,.475,14,19,.737,141
1880,WAS,2024-01-06,105,,NYK,L 105-121,240,40,85,.471,27,48,.563,13,37,.351,12,20,.600,105,43,87,.494,29,51,.569,14,36,.389,21,24,.875,121
1881,CHI,2023-12-30,105,,PHI,W 105-92,240,40,79,.506,33,54,.611,7,25,.280,18,30,.600,105,36,92,.391,27,54,.500,9,38,.237,11,15,.733,92
1882,UTA,2023-12-28,105,@,NOP,L 105-112,240,36,85,.424,24,46,.522,12,39,.308,21,25,.840,105,45,82,.549,35,55,.636,10,27,.370,12,15,.800,112
1883,POR,2023-12-28,105,,SAS,L 105-118,240,35,101,.347,24,65,.369,11,36,.306,24,32,.750,105,41,85,.482,31,49,.633,10,36,.278,26,28,.929,118
1884,MEM,2023-12-28,105,@,DEN,L 105-142,240,37,89,.416,24,54,.444,13,35,.371,18,25,.720,105,55,96,.573,35,55,.636,20,41,.488,12,14,.857,142
1885,PHO,2023-12-22,105,@,SAC,L 105-120,240,39,88,.443,34,63,.540,5,25,.200,22,28,.786,105,44,83,.530,32,45,.711,12,38,.316,20,26,.769,120
1886,MEM,2023-11-29,105,,UTA,W 105-91,240,43,87,.494,30,48,.625,13,39,.333,6,8,.750,105,34,90,.378,18,51,.353,16,39,.410,7,12,.583,91
1887,PHO,2023-11-29,105,@,TOR,L 105-112,240,38,94,.404,31,68,.456,7,26,.269,22,23,.957,105,42,93,.452,32,66,.485,10,27,.370,18,21,.857,112
1888,ATL,2023-11-28,105,@,CLE,L 105-128,240,35,101,.347,22,57,.386,13,44,.295,22,24,.917,105,50,93,.538,37,57,.649,13,36,.361,15,17,.882,128
1889,CLE,2023-11-26,105,,TOR,W 105-102,240,45,97,.464,35,66,.530,10,31,.323,5,6,.833,105,37,89,.416,29,57,.509,8,32,.250,20,29,.690,102
1890,UTA,2023-11-25,105,,NOP,W 105-100,240,38,87,.437,23,44,.523,15,43,.349,14,17,.824,105,39,93,.419,28,57,.491,11,36,.306,11,18,.611,100
1891,HOU,2023-11-24,105,,DEN,W 105-86,240,40,82,.488,28,53,.528,12,29,.414,13,15,.867,105,32,94,.340,25,64,.391,7,30,.233,15,21,.714,86
1892,UTA,2023-11-22,105,@,POR,L 105-121,240,37,79,.468,27,48,.563,10,31,.323,21,26,.808,105,47,92,.511,30,53,.566,17,39,.436,10,15,.667,121
1893,LAL,2023-11-19,105,,HOU,W 105-104,240,39,83,.470,33,54,.611,6,29,.207,21,29,.724,105,41,84,.488,27,47,.574,14,37,.378,8,10,.800,104
1894,TOR,2023-11-17,105,,BOS,L 105-108,240,42,87,.483,30,54,.556,12,33,.364,9,14,.643,105,42,92,.457,26,46,.565,16,46,.348,8,9,.889,108
1895,CHO,2023-11-14,105,,MIA,L 105-111,240,36,81,.444,21,49,.429,15,32,.469,18,22,.818,105,40,83,.482,32,52,.615,8,31,.258,23,28,.821,111
1896,MEM,2023-11-12,105,@,LAC,W 105-101,240,37,88,.420,24,47,.511,13,41,.317,18,24,.750,105,37,85,.435,25,51,.490,12,34,.353,15,23,.652,101
1897,SAC,2023-11-10,105,,OKC,W 105-98,240,38,91,.418,25,44,.568,13,47,.277,16,21,.762,105,39,87,.448,32,57,.561,7,30,.233,13,16,.813,98
1898,SAS,2023-11-08,105,@,NYK,L 105-126,240,44,90,.489,35,56,.625,9,34,.265,8,13,.615,105,46,100,.460,27,58,.466,19,42,.452,15,22,.682,126
1899,GSW,2023-11-08,105,@,DEN,L 105-108,240,37,86,.430,26,51,.510,11,35,.314,20,26,.769,105,41,92,.446,30,57,.526,11,35,.314,15,22,.682,108
1900,NOP,2023-11-04,105,,ATL,L 105-123,240,40,84,.476,32,53,.604,8,31,.258,17,21,.810,105,45,93,.484,31,52,.596,14,41,.341,19,24,.792,123
1901,NYK,2023-11-03,105,@,MIL,L 105-110,240,38,96,.396,28,57,.491,10,39,.256,19,25,.760,105,35,82,.427,15,43,.349,20,39,.513,20,28,.714,110
1902,MIA,2023-11-01,105,,BRK,L 105-109,240,39,91,.429,26,53,.491,13,38,.342,14,18,.778,105,37,82,.451,21,46,.457,16,36,.444,19,26,.731,109
1903,CHI,2023-11-01,105,@,DAL,L 105-114,240,42,89,.472,31,56,.554,11,33,.333,10,11,.909,105,37,81,.457,17,33,.515,20,48,.417,20,28,.714,114
1904,IND,2023-10-30,105,,CHI,L 105-112,240,36,88,.409,24,42,.571,12,46,.261,21,25,.840,105,40,87,.460,34,70,.486,6,17,.353,26,31,.839,112
1905,CLE,2023-10-27,105,,OKC,L 105-108,240,38,92,.413,26,47,.553,12,45,.267,17,23,.739,105,40,87,.460,27,61,.443,13,26,.500,15,19,.789,108
1906,MIL,2024-04-09,104,,BOS,W 104-91,240,43,81,.531,26,45,.578,17,36,.472,1,2,.500,104,37,93,.398,20,41,.488,17,52,.327,0,0,,91
1907,CHO,2024-04-09,104,,DAL,L 104-130,240,39,89,.438,29,57,.509,10,32,.313,16,21,.762,104,50,93,.538,33,43,.767,17,50,.340,13,20,.650,130
1908,HOU,2024-04-05,104,,MIA,L 104-119,240,34,90,.378,20,46,.435,14,44,.318,22,25,.880,104,44,89,.494,31,53,.585,13,36,.361,18,21,.857,119
1909,GSW,2024-04-02,104,,DAL,W 104-100,240,41,90,.456,26,58,.448,15,32,.469,7,7,1.000,104,39,89,.438,24,49,.490,15,40,.375,7,11,.636,100
1910,CHO,2024-04-01,104,,BOS,L 104-118,240,41,91,.451,28,54,.519,13,37,.351,9,11,.818,104,43,89,.483,24,36,.667,19,53,.358,13,16,.813,118
1911,ORL,2024-04-01,104,,POR,W 104-103,240,36,76,.474,25,44,.568,11,32,.344,21,27,.778,104,40,90,.444,29,59,.492,11,31,.355,12,15,.800,103
1912,BRK,2024-03-31,104,,LAL,L 104-116,240,39,92,.424,27,56,.482,12,36,.333,14,19,.737,104,42,77,.545,27,37,.730,15,40,.375,17,22,.773,116
1913,BOS,2024-03-30,104,@,NOP,W 104-92,240,39,82,.476,24,45,.533,15,37,.405,11,12,.917,104,34,86,.395,21,51,.412,13,35,.371,11,18,.611,92
1914,PHO,2024-03-27,104,@,DEN,W 104-97,240,39,83,.470,23,50,.460,16,33,.485,10,11,.909,104,38,88,.432,28,48,.583,10,40,.250,11,12,.917,97
1915,SAS,2024-03-25,104,,PHO,W 104-102,240,40,91,.440,32,60,.533,8,31,.258,16,19,.842,104,42,83,.506,32,55,.582,10,28,.357,8,14,.571,102
1916,MIN,2024-03-22,104,,CLE,W 104-91,240,41,85,.482,27,58,.466,14,27,.519,8,16,.500,104,34,81,.420,27,52,.519,7,29,.241,16,19,.842,91
1917,CLE,2024-03-20,104,,MIA,L 104-107,240,35,75,.467,20,33,.606,15,42,.357,19,22,.864,104,38,83,.458,25,47,.532,13,36,.361,18,19,.947,107
1918,NOP,2024-03-19,104,@,BRK,W 104-91,240,42,83,.506,32,49,.653,10,34,.294,10,13,.769,104,31,84,.369,19,44,.432,12,40,.300,17,22,.773,91
1919,UTA,2024-03-18,104,,MIN,L 104-114,240,39,84,.464,25,52,.481,14,32,.438,12,14,.857,104,44,91,.484,28,50,.560,16,41,.390,10,12,.833,114
1920,WAS,2024-03-17,104,,BOS,L 104-130,240,41,89,.461,31,55,.564,10,34,.294,12,14,.857,104,43,87,.494,19,37,.514,24,50,.480,20,24,.833,130
1921,MIA,2024-03-17,104,@,DET,W 104-101,240,40,89,.449,28,54,.519,12,35,.343,12,16,.750,104,38,83,.458,24,47,.511,14,36,.389,11,14,.786,101
1922,LAC,2024-03-15,104,@,NOP,L 104-112,240,37,77,.481,25,44,.568,12,33,.364,18,19,.947,104,42,87,.483,29,52,.558,13,35,.371,15,20,.750,112
1923,TOR,2024-03-13,104,@,DET,L 104-113,240,41,93,.441,32,57,.561,9,36,.250,13,19,.684,104,39,88,.443,28,58,.483,11,30,.367,24,31,.774,113
1924,SAC,2024-03-10,104,,HOU,L 104-112,240,39,86,.453,33,54,.611,6,32,.188,20,23,.870,104,39,84,.464,27,55,.491,12,29,.414,22,27,.815,112
1925,MIN,2024-03-08,104,@,CLE,L 104-113 (OT),265,39,94,.415,31,64,.484,8,30,.267,18,22,.818,104,38,88,.432,27,54,.500,11,34,.324,26,36,.722,113
1926,BOS,2024-03-05,104,@,CLE,L 104-105,240,39,93,.419,24,55,.436,15,38,.395,11,12,.917,104,39,90,.433,19,48,.396,20,42,.476,7,11,.636,105
1927,OKC,2024-03-04,104,@,LAL,L 104-116,240,37,94,.394,22,55,.400,15,39,.385,15,16,.938,104,41,80,.513,25,46,.543,16,34,.471,18,25,.720,116
1928,PHI,2024-02-23,104,,CLE,W 104-97,240,40,90,.444,28,61,.459,12,29,.414,12,15,.800,104,34,80,.425,26,53,.491,8,27,.296,21,31,.677,97
1929,PHI,2024-02-14,104,,MIA,L 104-109,240,41,86,.477,31,51,.608,10,35,.286,12,16,.750,104,42,88,.477,31,53,.585,11,35,.314,14,15,.933,109
1930,WAS,2024-02-12,104,@,DAL,L 104-112,240,44,106,.415,37,74,.500,7,32,.219,9,15,.600,104,43,96,.448,34,60,.567,9,36,.250,17,26,.654,112
1931,HOU,2024-02-09,104,@,TOR,L 104-107,240,38,85,.447,23,47,.489,15,38,.395,13,16,.813,104,40,95,.421,30,62,.484,10,33,.303,17,19,.895,107
1932,PHI,2024-02-07,104,,GSW,L 104-127,240,41,98,.418,33,66,.500,8,32,.250,14,14,1.000,104,47,94,.500,31,56,.554,16,38,.421,17,22,.773,127
1933,SAS,2024-02-07,104,@,MIA,L 104-116,240,41,90,.456,29,53,.547,12,37,.324,10,17,.588,104,43,87,.494,31,49,.633,12,38,.316,18,23,.783,116
1934,PHI,2024-01-29,104,@,POR,L 104-130,240,37,83,.446,32,54,.593,5,29,.172,25,28,.893,104,46,84,.548,34,56,.607,12,28,.429,26,29,.897,130
1935,CHI,2024-01-28,104,@,POR,W 104-96,240,42,90,.467,34,58,.586,8,32,.250,12,17,.706,104,32,79,.405,26,46,.565,6,33,.182,26,29,.897,96
1936,OKC,2024-01-28,104,@,DET,L 104-120,240,44,92,.478,36,64,.563,8,28,.286,8,12,.667,104,47,95,.495,36,69,.522,11,26,.423,15,19,.789,120
1937,HOU,2024-01-27,104,@,BRK,L 104-106,240,37,94,.394,27,57,.474,10,37,.270,20,23,.870,104,36,74,.486,24,40,.600,12,34,.353,22,37,.595,106
1938,DET,2024-01-27,104,,WAS,L 104-118,240,37,85,.435,28,53,.528,9,32,.281,21,27,.778,104,45,100,.450,34,66,.515,11,34,.324,17,21,.810,118
1939,CHO,2024-01-26,104,,HOU,L 104-138,240,35,85,.412,26,56,.464,9,29,.310,25,32,.781,104,50,89,.562,37,56,.661,13,33,.394,25,31,.806,138
1940,WAS,2024-01-21,104,,DEN,L 104-113,240,39,91,.429,31,64,.484,8,27,.296,18,22,.818,104,43,88,.489,35,66,.530,8,22,.364,19,28,.679,113
1941,ORL,2024-01-17,104,@,ATL,L 104-106,240,39,88,.443,29,53,.547,10,35,.286,16,22,.727,104,39,76,.513,31,51,.608,8,25,.320,20,22,.909,106
1942,MIA,2024-01-14,104,,CHO,W 104-87,240,40,81,.494,29,56,.518,11,25,.440,13,16,.813,104,33,95,.347,23,54,.426,10,41,.244,11,15,.733,87
1943,WAS,2024-01-10,104,@,IND,L 104-112,240,38,88,.432,31,57,.544,7,31,.226,21,30,.700,104,41,92,.446,33,67,.493,8,25,.320,22,24,.917,112
1944,CHI,2024-01-05,104,,CHO,W 104-91,240,40,74,.541,30,46,.652,10,28,.357,14,17,.824,104,36,89,.404,26,55,.473,10,34,.294,9,12,.750,91
1945,SAC,2024-01-02,104,,CHO,L 104-111,240,40,92,.435,26,56,.464,14,36,.389,10,17,.588,104,42,82,.512,30,48,.625,12,34,.353,15,19,.789,111
1946,MIA,2024-01-01,104,@,LAC,L 104-121,240,35,83,.422,24,49,.490,11,34,.324,23,29,.793,104,47,80,.588,33,51,.647,14,29,.483,13,14,.929,121
1947,BRK,2023-12-29,104,@,WAS,L 104-110,240,39,91,.429,30,63,.476,9,28,.321,17,27,.630,104,46,91,.505,31,53,.585,15,38,.395,3,7,.429,110
1948,CHI,2023-12-28,104,,IND,L 104-120,240,40,97,.412,33,70,.471,7,27,.259,17,22,.773,104,43,85,.506,24,43,.558,19,42,.452,15,22,.682,120
1949,CHO,2023-12-26,104,@,LAC,L 104-113,240,43,93,.462,37,64,.578,6,29,.207,12,16,.750,104,40,85,.471,26,51,.510,14,34,.412,19,25,.760,113
1950,NOP,2023-12-23,104,,HOU,L 104-106,240,38,82,.463,30,51,.588,8,31,.258,20,29,.690,104,35,82,.427,26,53,.491,9,29,.310,27,35,.771,106
1951,CLE,2023-12-21,104,,NOP,L 104-123,240,41,87,.471,24,43,.558,17,44,.386,5,8,.625,104,47,86,.547,32,51,.627,15,35,.429,14,16,.875,123
1952,TOR,2023-12-20,104,,DEN,L 104-113,240,43,90,.478,34,63,.540,9,27,.333,9,13,.692,104,49,98,.500,37,65,.569,12,33,.364,3,7,.429,113
1953,PHO,2023-12-19,104,@,POR,L 104-109,240,42,94,.447,37,71,.521,5,23,.217,15,21,.714,104,39,87,.448,25,59,.424,14,28,.500,17,19,.895,109
1954,DAL,2023-12-18,104,@,DEN,L 104-130,240,41,92,.446,28,54,.519,13,38,.342,9,19,.474,104,49,87,.563,35,61,.574,14,26,.538,18,22,.818,130
1955,PHI,2023-12-18,104,,CHI,L 104-108,240,38,88,.432,27,56,.482,11,32,.344,17,19,.895,104,42,89,.472,30,60,.500,12,29,.414,12,15,.800,108
1956,UTA,2023-12-16,104,@,SAC,L 104-125,240,38,86,.442,26,49,.531,12,37,.324,16,21,.762,104,46,85,.541,24,40,.600,22,45,.489,11,15,.733,125
1957,TOR,2023-12-15,104,,ATL,L 104-125,240,40,77,.519,30,46,.652,10,31,.323,14,25,.560,104,52,101,.515,36,60,.600,16,41,.390,5,6,.833,125
1958,CHO,2023-12-13,104,@,MIA,L 104-115,240,41,77,.532,29,46,.630,12,31,.387,10,11,.909,104,41,86,.477,26,56,.464,15,30,.500,18,19,.947,115
1959,MEM,2023-12-13,104,@,HOU,L 104-117,240,35,82,.427,25,44,.568,10,38,.263,24,34,.706,104,39,86,.453,27,54,.500,12,32,.375,27,37,.730,117
1960,ORL,2023-12-11,104,,CLE,W 104-94,240,39,84,.464,32,58,.552,7,26,.269,19,25,.760,104,30,85,.353,21,45,.467,9,40,.225,25,33,.758,94
1961,LAC,2023-11-27,104,,DEN,L 104-113,240,35,85,.412,29,65,.446,6,20,.300,28,34,.824,104,44,92,.478,34,70,.486,10,22,.455,15,28,.536,113
1962,DAL,2023-11-22,104,@,LAL,W 104-101,240,38,96,.396,22,46,.478,16,50,.320,12,16,.750,104,39,84,.464,28,55,.509,11,29,.379,12,19,.632,101
1963,HOU,2023-11-19,104,@,LAL,L 104-105,240,41,84,.488,27,47,.574,14,37,.378,8,10,.800,104,39,83,.470,33,54,.611,6,29,.207,21,29,.724,105
1964,ORL,2023-11-14,104,@,BRK,L 104-124,240,36,82,.439,20,36,.556,16,46,.348,16,21,.762,104,46,85,.541,27,46,.587,19,39,.487,13,20,.650,124
1965,MIN,2023-11-14,104,@,GSW,W 104-101,240,36,81,.444,22,47,.468,14,34,.412,18,21,.857,104,37,88,.420,24,49,.490,13,39,.333,14,16,.875,101
1966,DEN,2023-11-12,104,@,HOU,L 104-107,240,42,91,.462,33,59,.559,9,32,.281,11,14,.786,104,37,87,.425,27,55,.491,10,32,.313,23,29,.793,107
1967,HOU,2023-11-10,104,,NOP,W 104-101,240,36,88,.409,26,53,.491,10,35,.286,22,28,.786,104,34,75,.453,26,50,.520,8,25,.320,25,34,.735,101
1968,GSW,2023-11-05,104,@,CLE,L 104-115,240,34,94,.362,18,53,.340,16,41,.390,20,30,.667,104,41,83,.494,30,46,.652,11,37,.297,22,28,.786,115
1969,IND,2023-11-01,104,@,BOS,L 104-155,240,46,101,.455,41,64,.641,5,37,.135,7,12,.583,104,54,95,.568,34,60,.567,20,35,.571,27,28,.964,155
1970,UTA,2023-10-28,104,@,PHO,L 104-126,240,40,91,.440,28,54,.519,12,37,.324,12,14,.857,104,45,85,.529,35,48,.729,10,37,.270,26,28,.929,126
1971,CHI,2023-10-27,104,,TOR,W 104-103 (OT),265,37,99,.374,29,60,.483,8,39,.205,22,28,.786,104,39,84,.464,30,48,.625,9,36,.250,16,25,.640,103
1972,MEM,2023-10-27,104,,DEN,L 104-108,240,37,85,.435,27,52,.519,10,33,.303,20,24,.833,104,41,88,.466,27,51,.529,14,37,.378,12,18,.667,108
1973,MEM,2023-10-25,104,,NOP,L 104-111,240,38,91,.418,26,48,.542,12,43,.279,16,20,.800,104,40,85,.471,26,53,.491,14,32,.438,17,22,.773,111
1974,CHI,2023-10-25,104,,OKC,L 104-124,240,39,94,.415,27,52,.519,12,42,.286,14,18,.778,104,45,82,.549,26,43,.605,19,39,.487,15,18,.833,124
1975,NYK,2023-10-25,104,,BOS,L 104-108,240,36,97,.371,18,56,.321,18,41,.439,14,26,.538,104,37,77,.481,25,38,.658,12,39,.308,22,26,.846,108
1976,GSW,2023-10-24,104,,PHO,L 104-108,240,36,101,.356,26,58,.448,10,43,.233,22,28,.786,104,42,95,.442,31,62,.500,11,33,.333,13,17,.765,108
1977,TOR,2024-04-14,103,@,MIA,L 103-118,240,38,90,.422,29,56,.518,9,34,.265,18,21,.857,103,46,87,.529,37,51,.725,9,36,.250,17,19,.895,118
1978,TOR,2024-04-12,103,@,MIA,L 103-125,240,37,77,.481,27,46,.587,10,31,.323,19,22,.864,103,45,86,.523,28,45,.622,17,41,.415,18,23,.783,125
1979,DET,2024-04-06,103,@,BRK,L 103-113,240,42,92,.457,25,53,.472,17,39,.436,2,4,.500,103,38,73,.521,27,46,.587,11,27,.407,26,33,.788,113
1980,POR,2024-04-01,103,@,ORL,L 103-104,240,40,90,.444,29,59,.492,11,31,.355,12,15,.800,103,36,76,.474,25,44,.568,11,32,.344,21,27,.778,104
1981,PHO,2024-03-29,103,@,OKC,L 103-128,240,39,87,.448,26,46,.565,13,41,.317,12,15,.800,103,49,87,.563,33,57,.579,16,30,.533,14,14,1.000,128
1982,SAC,2024-03-29,103,,DAL,L 103-107,240,40,92,.435,25,60,.417,15,32,.469,8,12,.667,103,35,74,.473,20,39,.513,15,35,.429,22,33,.667,107
1983,MEM,2024-03-25,103,@,DEN,L 103-128,240,37,94,.394,26,50,.520,11,44,.250,18,27,.667,103,48,90,.533,33,58,.569,15,32,.469,17,18,.944,128
1984,TOR,2024-03-22,103,,OKC,L 103-123,240,40,76,.526,29,46,.630,11,30,.367,12,17,.706,103,48,95,.505,36,63,.571,12,32,.375,15,19,.789,123
1985,POR,2024-03-20,103,,LAC,L 103-116,240,39,81,.481,24,47,.511,15,34,.441,10,15,.667,103,45,86,.523,32,55,.582,13,31,.419,13,15,.867,116
1986,DET,2024-03-20,103,,IND,L 103-122,240,37,90,.411,32,67,.478,5,23,.217,24,30,.800,103,50,88,.568,39,59,.661,11,29,.379,11,18,.611,122
1987,IND,2024-03-18,103,,CLE,L 103-108,240,42,91,.462,33,53,.623,9,38,.237,10,16,.625,103,38,80,.475,26,48,.542,12,32,.375,20,28,.714,108
1988,CLE,2024-03-16,103,@,HOU,L 103-117,240,37,82,.451,25,44,.568,12,38,.316,17,20,.850,103,47,98,.480,32,56,.571,15,42,.357,8,12,.667,117
1989,TOR,2024-03-15,103,,ORL,L 103-113,240,38,81,.469,24,47,.511,14,34,.412,13,20,.650,103,40,80,.500,26,49,.531,14,31,.452,19,22,.864,113
1990,HOU,2024-03-12,103,@,SAS,W 103-101,240,37,80,.463,27,48,.563,10,32,.313,19,21,.905,103,39,82,.476,28,46,.609,11,36,.306,12,14,.857,101
1991,ATL,2024-03-10,103,,NOP,L 103-116,240,38,91,.418,21,45,.467,17,46,.370,10,13,.769,103,43,75,.573,29,48,.604,14,27,.519,16,22,.727,116
1992,NOP,2024-03-08,103,@,PHI,W 103-95,240,35,79,.443,24,48,.500,11,31,.355,22,23,.957,103,35,88,.398,26,51,.510,9,37,.243,16,20,.800,95
1993,DEN,2024-02-29,103,,MIA,W 103-97,240,36,84,.429,24,50,.480,12,34,.353,19,21,.905,103,35,83,.422,28,57,.491,7,26,.269,20,24,.833,97
1994,GSW,2024-02-25,103,,DEN,L 103-119,240,35,81,.432,24,47,.511,11,34,.324,22,29,.759,103,43,88,.489,32,56,.571,11,32,.344,22,26,.846,119
1995,NYK,2024-02-12,103,@,HOU,L 103-105,240,42,92,.457,30,56,.536,12,36,.333,7,12,.583,103,36,80,.450,26,54,.481,10,26,.385,23,33,.697,105
1996,SAS,2024-02-10,103,@,BRK,L 103-123,240,36,91,.396,25,57,.439,11,34,.324,20,21,.952,103,49,87,.563,32,53,.604,17,34,.500,8,11,.727,123
1997,LAC,2024-02-04,103,@,MIA,W 103-95,240,34,77,.442,18,38,.474,16,39,.410,19,22,.864,103,38,91,.418,30,61,.492,8,30,.267,11,12,.917,95
1998,POR,2024-02-04,103,@,DEN,L 103-112,240,39,85,.459,28,54,.519,11,31,.355,14,15,.933,103,42,86,.488,30,58,.517,12,28,.429,16,19,.842,112
1999,UTA,2024-01-30,103,@,NYK,L 103-118,240,39,86,.453,27,50,.540,12,36,.333,13,17,.765,103,44,94,.468,31,60,.517,13,34,.382,17,18,.944,118
2000,SAC,2024-01-29,103,@,MEM,W 103-94,240,43,84,.512,32,46,.696,11,38,.289,6,10,.600,103,30,80,.375,17,44,.386,13,36,.361,21,28,.750,94
2001,BRK,2024-01-23,103,,NYK,L 103-108,240,42,95,.442,27,53,.509,15,42,.357,4,5,.800,103,40,86,.465,30,57,.526,10,29,.345,18,19,.947,108
2002,MEM,2024-01-18,103,@,MIN,L 103-118,240,39,85,.459,25,51,.490,14,34,.412,11,17,.647,103,45,82,.549,33,54,.611,12,28,.429,16,21,.762,118
2003,BRK,2024-01-17,103,@,POR,L 103-105,240,35,73,.479,20,35,.571,15,38,.395,18,27,.667,103,42,86,.488,33,59,.559,9,27,.333,12,14,.857,105
2004,DAL,2024-01-09,103,,MEM,L 103-120,240,36,82,.439,27,55,.491,9,27,.333,22,27,.815,103,44,91,.484,30,54,.556,14,37,.378,18,21,.857,120
2005,LAC,2024-01-07,103,@,LAL,L 103-106,240,36,91,.396,22,54,.407,14,37,.378,17,19,.895,103,42,82,.512,31,53,.585,11,29,.379,11,16,.688,106
2006,POR,2024-01-05,103,@,DAL,L 103-139,240,39,95,.411,26,55,.473,13,40,.325,12,17,.706,103,56,96,.583,39,58,.672,17,38,.447,10,15,.667,139
2007,IND,2023-12-21,103,@,MEM,L 103-116,240,38,90,.422,20,38,.526,18,52,.346,9,11,.818,103,43,84,.512,27,49,.551,16,35,.457,14,21,.667,116
2008,HOU,2023-12-15,103,@,MEM,W 103-96,240,32,88,.364,21,59,.356,11,29,.379,28,32,.875,103,37,92,.402,26,52,.500,11,40,.275,11,15,.733,96
2009,MEM,2023-12-08,103,,MIN,L 103-127,240,37,86,.430,22,51,.431,15,35,.429,14,19,.737,103,44,88,.500,29,50,.580,15,38,.395,24,26,.923,127
2010,UTA,2023-12-08,103,,LAC,L 103-117,240,38,84,.452,29,53,.547,9,31,.290,18,24,.750,103,43,88,.489,28,54,.519,15,34,.441,16,21,.762,117
2011,TOR,2023-12-06,103,,MIA,L 103-112,240,37,86,.430,23,49,.469,14,37,.378,15,17,.882,103,41,89,.461,27,51,.529,14,38,.368,16,19,.842,112
2012,PHO,2023-12-05,103,@,LAL,L 103-106,240,37,75,.493,25,50,.500,12,25,.480,17,21,.810,103,38,102,.373,29,72,.403,9,30,.300,21,25,.840,106
2013,POR,2023-11-30,103,@,CLE,W 103-95,240,39,77,.506,25,42,.595,14,35,.400,11,11,1.000,103,38,89,.427,31,57,.544,7,32,.219,12,12,1.000,95
2014,TOR,2023-11-28,103,@,BRK,L 103-115,240,39,101,.386,26,65,.400,13,36,.361,12,19,.632,103,40,89,.449,27,51,.529,13,38,.342,22,26,.846,115
2015,OKC,2023-11-28,103,@,MIN,L 103-106,240,37,90,.411,26,60,.433,11,30,.367,18,23,.783,103,33,78,.423,19,45,.422,14,33,.424,26,32,.813,106
2016,ATL,2023-11-26,103,@,BOS,L 103-113,240,36,88,.409,17,35,.486,19,53,.358,12,19,.632,103,42,95,.442,29,48,.604,13,47,.277,16,20,.800,113
2017,DET,2023-11-20,103,,DEN,L 103-107,240,36,81,.444,29,60,.483,7,21,.333,24,26,.923,103,40,87,.460,29,59,.492,11,28,.393,16,21,.762,107
2018,ORL,2023-11-17,103,@,CHI,W 103-97,240,38,79,.481,27,45,.600,11,34,.324,16,23,.696,103,35,79,.443,25,50,.500,10,29,.345,17,22,.773,97
2019,BOS,2023-11-08,103,@,PHI,L 103-106,240,36,91,.396,21,44,.477,15,47,.319,16,19,.842,103,42,95,.442,33,61,.541,9,34,.265,13,15,.867,106
2020,ORL,2023-10-30,103,@,LAL,L 103-106,240,38,95,.400,24,60,.400,14,35,.400,13,18,.722,103,42,79,.532,34,52,.654,8,27,.296,14,18,.778,106
2021,TOR,2023-10-27,103,@,CHI,L 103-104 (OT),265,39,84,.464,30,48,.625,9,36,.250,16,25,.640,103,37,99,.374,29,60,.483,8,39,.205,22,28,.786,104
2022,MIA,2023-10-25,103,,DET,W 103-102,240,37,92,.402,29,70,.414,8,22,.364,21,26,.808,103,41,92,.446,30,60,.500,11,32,.344,9,15,.600,102
2023,TOR,2024-04-10,102,@,BRK,L 102-106,240,35,94,.372,19,54,.352,16,40,.400,16,18,.889,102,38,86,.442,27,50,.540,11,36,.306,19,24,.792,106
2024,DET,2024-04-09,102,@,PHI,L 102-120,240,34,84,.405,20,54,.370,14,30,.467,20,24,.833,102,44,98,.449,31,61,.508,13,37,.351,19,23,.826,120
2025,SAS,2024-04-09,102,@,MEM,W 102-87,240,42,87,.483,32,47,.681,10,40,.250,8,8,1.000,102,36,104,.346,30,74,.405,6,30,.200,9,11,.818,87
2026,WAS,2024-04-05,102,,POR,L 102-108,240,38,88,.432,33,55,.600,5,33,.152,21,30,.700,102,41,94,.436,32,65,.492,9,29,.310,17,24,.708,108
2027,UTA,2024-04-05,102,@,LAC,L 102-131,240,35,91,.385,26,61,.426,9,30,.300,23,29,.793,102,51,91,.560,38,56,.679,13,35,.371,16,18,.889,131
2028,LAC,2024-04-04,102,,DEN,W 102-100,240,34,90,.378,27,57,.474,7,33,.212,27,32,.844,102,36,83,.434,25,48,.521,11,35,.314,17,25,.680,100
2029,PHO,2024-03-25,102,@,SAS,L 102-104,240,42,83,.506,32,55,.582,10,28,.357,8,14,.571,102,40,91,.440,32,60,.533,8,31,.258,16,19,.842,104
2030,DET,2024-03-22,102,,BOS,L 102-129,240,42,83,.506,33,52,.635,9,31,.290,9,13,.692,102,47,89,.528,31,44,.705,16,45,.356,19,27,.704,129
2031,SAC,2024-03-21,102,@,WAS,L 102-109,240,37,86,.430,26,47,.553,11,39,.282,17,19,.895,102,41,81,.506,31,56,.554,10,25,.400,17,23,.739,109
2032,PHI,2024-03-20,102,@,PHO,L 102-115,240,41,95,.432,28,58,.483,13,37,.351,7,18,.389,102,45,90,.500,26,51,.510,19,39,.487,6,8,.750,115
2033,ATL,2024-03-13,102,@,POR,L 102-106,240,38,88,.432,24,49,.490,14,39,.359,12,18,.667,102,38,82,.463,28,52,.538,10,30,.333,20,24,.833,106
2034,SAS,2024-03-11,102,,GSW,L 102-112,240,39,93,.419,25,56,.446,14,37,.378,10,15,.667,102,46,93,.495,34,66,.515,12,27,.444,8,12,.667,112
2035,CHI,2024-03-09,102,@,LAC,L 102-112,240,37,86,.430,24,51,.471,13,35,.371,15,19,.789,102,42,84,.500,30,49,.612,12,35,.343,16,18,.889,112
2036,BRK,2024-03-04,102,,MEM,L 102-106,240,35,79,.443,20,37,.541,15,42,.357,17,30,.567,102,38,82,.463,26,45,.578,12,37,.324,18,22,.818,106
2037,ATL,2024-03-02,102,@,BRK,L 102-114,240,37,87,.425,26,53,.491,11,34,.324,17,23,.739,102,41,88,.466,26,56,.464,15,32,.469,17,22,.773,114
2038,IND,2024-03-01,102,@,NOP,L 102-129,240,40,95,.421,30,63,.476,10,32,.313,12,18,.667,102,48,86,.558,33,54,.611,15,32,.469,18,26,.692,129
2039,NYK,2024-02-24,102,,BOS,L 102-116,240,37,82,.451,24,44,.545,13,38,.342,15,16,.938,102,46,81,.568,31,46,.674,15,35,.429,9,12,.750,116
2040,SAC,2024-02-14,102,@,DEN,W 102-98,240,39,89,.438,30,56,.536,9,33,.273,15,19,.789,102,35,89,.393,26,63,.413,9,26,.346,19,22,.864,98
2041,IND,2024-02-12,102,@,CHO,L 102-111,240,42,83,.506,34,53,.642,8,30,.267,10,16,.625,102,44,82,.537,34,48,.708,10,34,.294,13,16,.813,111
2042,PHI,2024-02-05,102,,DAL,L 102-118,240,40,93,.430,32,64,.500,8,29,.276,14,20,.700,102,42,87,.483,25,44,.568,17,43,.395,17,23,.739,118
2043,WAS,2024-02-02,102,,MIA,L 102-110,240,37,90,.411,26,48,.542,11,42,.262,17,21,.810,102,38,88,.432,31,57,.544,7,31,.226,27,35,.771,110
2044,OKC,2024-01-20,102,@,MIN,W 102-97,240,32,81,.395,24,57,.421,8,24,.333,30,35,.857,102,31,75,.413,17,38,.447,14,37,.378,21,29,.724,97
2045,DEN,2024-01-19,102,@,BOS,W 102-100,240,42,81,.519,34,50,.680,8,31,.258,10,13,.769,102,38,89,.427,24,45,.533,14,44,.318,10,14,.714,100
2046,BOS,2024-01-11,102,@,MIL,L 102-135,240,34,91,.374,25,56,.446,9,35,.257,25,30,.833,102,52,92,.565,34,50,.680,18,42,.429,13,16,.813,135
2047,BRK,2024-01-11,102,@,CLE,L 102-111,240,37,82,.451,29,55,.527,8,27,.296,20,28,.714,102,32,82,.390,19,38,.500,13,44,.295,34,43,.791,111
2048,GSW,2023-12-28,102,,MIA,L 102-114,240,37,88,.420,29,55,.527,8,33,.242,20,25,.800,102,44,91,.484,34,60,.567,10,31,.323,16,22,.727,114
2049,WAS,2023-12-27,102,,TOR,L 102-132,240,42,90,.467,34,57,.596,8,33,.242,10,15,.667,102,52,91,.571,37,53,.698,15,38,.395,13,19,.684,132
2050,DEN,2023-12-23,102,@,CHO,W 102-95,240,39,90,.433,27,60,.450,12,30,.400,12,14,.857,102,34,88,.386,26,60,.433,8,28,.286,19,23,.826,95
2051,BRK,2023-12-20,102,,NYK,L 102-121,240,37,101,.366,22,54,.407,15,47,.319,13,17,.765,102,44,95,.463,31,62,.500,13,33,.394,20,25,.800,121
2052,DET,2023-12-06,102,,MEM,L 102-116,240,41,91,.451,30,56,.536,11,35,.314,9,9,1.000,102,47,91,.516,36,65,.554,11,26,.423,11,14,.786,116
2053,MIN,2023-12-06,102,,SAS,W 102-94,240,36,87,.414,24,47,.511,12,40,.300,18,21,.857,102,38,101,.376,30,65,.462,8,36,.222,10,15,.667,94
2054,DEN,2023-12-06,102,@,LAC,L 102-111,240,41,98,.418,29,67,.433,12,31,.387,8,9,.889,102,40,87,.460,28,60,.467,12,27,.444,19,25,.760,111
2055,TOR,2023-11-26,102,@,CLE,L 102-105,240,37,89,.416,29,57,.509,8,32,.250,20,29,.690,102,45,97,.464,35,66,.530,10,31,.323,5,6,.833,105
2056,POR,2023-11-26,102,@,MIL,L 102-108,240,37,91,.407,24,59,.407,13,32,.406,15,20,.750,102,35,89,.393,21,47,.447,14,42,.333,24,32,.750,108
2057,SAS,2023-11-22,102,,LAC,L 102-109,240,35,91,.385,24,53,.453,11,38,.289,21,23,.913,102,39,85,.459,30,57,.526,9,28,.321,22,29,.759,109
2058,CHI,2023-11-22,102,@,OKC,L 102-116,240,34,88,.386,17,44,.386,17,44,.386,17,17,1.000,102,37,75,.493,26,46,.565,11,29,.379,31,38,.816,116
2059,BOS,2023-11-19,102,@,MEM,W 102-100,240,35,77,.455,23,46,.500,12,31,.387,20,25,.800,102,37,95,.389,20,51,.392,17,44,.386,9,10,.900,100
2060,CHI,2023-11-18,102,,MIA,W 102-97,240,36,81,.444,20,36,.556,16,45,.356,14,19,.737,102,33,77,.429,21,41,.512,12,36,.333,19,23,.826,97
2061,BRK,2023-11-12,102,,WAS,W 102-94,240,37,98,.378,25,49,.510,12,49,.245,16,20,.800,102,33,88,.375,23,47,.489,10,41,.244,18,25,.720,94
2062,MEM,2023-11-08,102,,MIA,L 102-108,240,35,90,.389,24,53,.453,11,37,.297,21,28,.750,102,35,77,.455,24,49,.490,11,28,.393,27,32,.844,108
2063,ORL,2023-11-06,102,,DAL,L 102-117,240,40,85,.471,32,58,.552,8,27,.296,14,18,.778,102,41,82,.500,26,42,.619,15,40,.375,20,28,.714,117
2064,GSW,2023-11-01,102,,SAC,W 102-101,240,39,81,.481,28,50,.560,11,31,.355,13,15,.867,102,36,88,.409,25,53,.472,11,35,.314,18,23,.783,101
2065,ORL,2023-10-31,102,@,LAC,L 102-118,240,38,81,.469,31,51,.608,7,30,.233,19,33,.576,102,44,89,.494,30,58,.517,14,31,.452,16,23,.696,118
2066,NOP,2023-10-30,102,,GSW,L 102-130,240,38,93,.409,28,54,.519,10,39,.256,16,26,.615,102,51,98,.520,36,57,.632,15,41,.366,13,20,.650,130
2067,UTA,2023-10-30,102,@,DEN,L 102-110,240,42,98,.429,31,61,.508,11,37,.297,7,15,.467,102,47,84,.560,38,56,.679,9,28,.321,7,17,.412,110
2068,CHI,2023-10-28,102,@,DET,L 102-118,240,39,93,.419,28,65,.431,11,28,.393,13,16,.813,102,45,86,.523,33,58,.569,12,28,.429,16,20,.800,118
2069,ORL,2023-10-27,102,@,POR,W 102-97,240,36,79,.456,27,51,.529,9,28,.321,21,32,.656,102,35,88,.398,26,56,.464,9,32,.281,18,21,.857,97
2070,DET,2023-10-25,102,@,MIA,L 102-103,240,41,92,.446,30,60,.500,11,32,.344,9,15,.600,102,37,92,.402,29,70,.414,8,22,.364,21,26,.808,103
2071,BOS,2024-04-05,101,,SAC,W 101-100,240,38,89,.427,26,45,.578,12,44,.273,13,18,.722,101,38,99,.384,21,48,.438,17,51,.333,7,13,.538,100
2072,CLE,2024-04-03,101,@,PHO,L 101-122,240,39,83,.470,32,57,.561,7,26,.269,16,19,.842,101,44,87,.506,26,54,.481,18,33,.545,16,17,.941,122
2073,MIL,2024-04-03,101,,MEM,L 101-111,240,38,95,.400,20,51,.392,18,44,.409,7,12,.583,101,46,91,.505,39,68,.574,7,23,.304,12,17,.706,111
2074,CHI,2024-04-01,101,,ATL,L 101-113,240,37,94,.394,30,66,.455,7,28,.250,20,24,.833,101,41,82,.500,22,42,.524,19,40,.475,12,18,.667,113
2075,MIN,2024-03-31,101,,CHI,L 101-109,240,38,81,.469,27,44,.614,11,37,.297,14,21,.667,101,42,80,.525,25,51,.490,17,29,.586,8,12,.667,109
2076,CLE,2024-03-31,101,@,DEN,L 101-130,240,38,82,.463,30,57,.526,8,25,.320,17,21,.810,101,50,87,.575,29,54,.537,21,33,.636,9,13,.692,130
2077,HOU,2024-03-29,101,@,UTA,W 101-100,240,35,91,.385,22,49,.449,13,42,.310,18,28,.643,101,37,80,.463,29,49,.592,8,31,.258,18,19,.947,100
2078,GSW,2024-03-27,101,@,ORL,W 101-93,240,40,90,.444,30,56,.536,10,34,.294,11,13,.846,101,36,85,.424,26,53,.491,10,32,.313,11,21,.524,93
2079,TOR,2024-03-27,101,,NYK,L 101-145,240,39,84,.464,28,53,.528,11,31,.355,12,13,.923,101,55,94,.585,33,50,.660,22,44,.500,13,16,.813,145
2080,DET,2024-03-24,101,,NOP,L 101-114,240,32,79,.405,21,38,.553,11,41,.268,26,32,.813,101,41,81,.506,30,47,.638,11,34,.324,21,31,.677,114
2081,LAL,2024-03-22,101,,PHI,W 101-94,240,32,73,.438,20,42,.476,12,31,.387,25,33,.758,101,33,96,.344,25,59,.424,8,37,.216,20,24,.833,94
2082,DET,2024-03-17,101,,MIA,L 101-104,240,38,83,.458,24,47,.511,14,36,.389,11,14,.786,101,40,89,.449,28,54,.519,12,35,.343,12,16,.750,104
2083,SAS,2024-03-12,101,,HOU,L 101-103,240,39,82,.476,28,46,.609,11,36,.306,12,14,.857,101,37,80,.463,27,48,.563,10,32,.313,19,21,.905,103
2084,CLE,2024-03-10,101,,BRK,L 101-120,240,37,76,.487,23,44,.523,14,32,.438,13,20,.650,101,42,79,.532,24,44,.545,18,35,.514,18,20,.900,120
2085,CLE,2024-03-06,101,@,ATL,L 101-112,240,39,89,.438,29,45,.644,10,44,.227,13,17,.765,101,43,84,.512,32,54,.593,11,30,.367,15,20,.750,112
2086,ORL,2024-03-05,101,@,CHO,W 101-89,240,40,74,.541,27,39,.692,13,35,.371,8,15,.533,101,33,72,.458,21,39,.538,12,33,.364,11,11,1.000,89
2087,SAS,2024-03-05,101,@,HOU,L 101-114,240,38,87,.437,26,51,.510,12,36,.333,13,16,.813,101,49,105,.467,40,71,.563,9,34,.265,7,11,.636,114
2088,MEM,2024-02-28,101,@,MIN,L 101-110,240,36,93,.387,25,56,.446,11,37,.297,18,20,.900,101,39,79,.494,25,44,.568,14,35,.400,18,22,.818,110
2089,MIN,2024-02-24,101,,BRK,W 101-86,240,36,84,.429,24,46,.522,12,38,.316,17,23,.739,101,35,104,.337,29,69,.420,6,35,.171,10,11,.909,86
2090,LAC,2024-02-23,101,@,MEM,W 101-95,240,37,84,.440,25,52,.481,12,32,.375,15,17,.882,101,38,91,.418,30,56,.536,8,35,.229,11,16,.688,95
2091,SAS,2024-02-03,101,,CLE,L 101-117,240,36,98,.367,24,58,.414,12,40,.300,17,21,.810,101,46,97,.474,33,53,.623,13,44,.295,12,13,.923,117
2092,MEM,2024-02-02,101,,GSW,L 101-121,240,35,87,.402,21,41,.512,14,46,.304,17,24,.708,101,46,83,.554,35,54,.648,11,29,.379,18,22,.818,121
2093,MEM,2024-02-01,101,,CLE,L 101-108,240,37,90,.411,25,52,.481,12,38,.316,15,17,.882,101,41,86,.477,27,51,.529,14,35,.400,12,18,.667,108
2094,OKC,2024-01-29,101,,MIN,L 101-107,240,35,79,.443,21,44,.477,14,35,.400,17,22,.773,101,40,83,.482,26,54,.481,14,29,.483,13,15,.867,107
2095,IND,2024-01-06,101,,BOS,L 101-118,240,38,92,.413,30,50,.600,8,42,.190,17,22,.773,101,46,90,.511,30,49,.612,16,41,.390,10,19,.526,118
2096,BRK,2024-01-03,101,@,HOU,L 101-112,240,36,93,.387,23,49,.469,13,44,.295,16,26,.615,101,37,76,.487,18,37,.486,19,39,.487,19,27,.704,112
2097,WAS,2024-01-03,101,@,CLE,L 101-140,240,42,101,.416,30,66,.455,12,35,.343,5,11,.455,101,54,101,.535,34,59,.576,20,42,.476,12,16,.750,140
2098,SAS,2023-12-31,101,,BOS,L 101-134,240,40,94,.426,28,49,.571,12,45,.267,9,12,.750,101,51,95,.537,36,53,.679,15,42,.357,17,22,.773,134
2099,DAL,2023-12-14,101,,MIN,L 101-119,240,39,83,.470,32,51,.627,7,32,.219,16,18,.889,101,44,88,.500,30,57,.526,14,31,.452,17,25,.680,119
2100,BRK,2023-12-14,101,@,DEN,L 101-124,240,39,95,.411,31,65,.477,8,30,.267,15,20,.750,101,47,99,.475,35,63,.556,12,36,.333,18,21,.857,124
2101,WAS,2023-12-11,101,@,PHI,L 101-146,240,36,85,.424,27,54,.500,9,31,.290,20,31,.645,101,52,95,.547,32,49,.653,20,46,.435,22,25,.880,146
2102,OKC,2023-12-06,101,@,HOU,L 101-110,240,37,87,.425,29,58,.500,8,29,.276,19,24,.792,101,40,83,.482,25,50,.500,15,33,.455,15,22,.682,110
2103,DET,2023-12-02,101,,CLE,L 101-110,240,39,83,.470,31,53,.585,8,30,.267,15,23,.652,101,44,89,.494,34,59,.576,10,30,.333,12,18,.667,110
2104,ORL,2023-12-02,101,@,BRK,L 101-129,240,35,88,.398,26,59,.441,9,29,.310,22,27,.815,101,46,91,.505,32,57,.561,14,34,.412,23,31,.742,129
2105,MIN,2023-11-30,101,,UTA,W 101-90,240,39,89,.438,26,54,.481,13,35,.371,10,13,.769,101,33,87,.379,22,53,.415,11,34,.324,13,14,.929,90
2106,LAL,2023-11-22,101,,DAL,L 101-104,240,39,84,.464,28,55,.509,11,29,.379,12,19,.632,101,38,96,.396,22,46,.478,16,50,.320,12,16,.750,104
2107,GSW,2023-11-14,101,,MIN,L 101-104,240,37,88,.420,24,49,.490,13,39,.333,14,16,.875,101,36,81,.444,22,47,.468,14,34,.412,18,21,.857,104
2108,LAC,2023-11-12,101,,MEM,L 101-105,240,37,85,.435,25,51,.490,12,34,.353,15,23,.652,101,37,88,.420,24,47,.511,13,41,.317,18,24,.750,105
2109,NOP,2023-11-10,101,@,HOU,L 101-104,240,34,75,.453,26,50,.520,8,25,.320,25,34,.735,101,36,88,.409,26,53,.491,10,35,.286,22,28,.786,104
2110,NOP,2023-11-08,101,@,MIN,L 101-122,240,36,93,.387,28,65,.431,8,28,.286,21,22,.955,101,45,82,.549,30,45,.667,15,37,.405,17,24,.708,122
2111,LAL,2023-11-04,101,@,ORL,L 101-120,240,37,84,.440,29,54,.537,8,30,.267,19,21,.905,101,46,101,.455,34,68,.500,12,33,.364,16,19,.842,120
2112,CHI,2023-11-04,101,@,DEN,L 101-123,240,39,86,.453,32,60,.533,7,26,.269,16,23,.696,101,42,81,.519,26,45,.578,16,36,.444,23,30,.767,123
2113,SAC,2023-11-01,101,@,GSW,L 101-102,240,36,88,.409,25,53,.472,11,35,.314,18,23,.783,101,39,81,.481,28,50,.560,11,31,.355,13,15,.867,102
2114,DET,2023-11-01,101,,POR,L 101-110,240,40,90,.444,29,61,.475,11,29,.379,10,11,.909,101,38,81,.469,31,61,.508,7,20,.350,27,33,.818,110
2115,GSW,2024-04-11,100,@,POR,W 100-92,240,36,77,.468,24,42,.571,12,35,.343,16,20,.800,100,35,97,.361,27,63,.429,8,34,.235,14,17,.824,92
2116,POR,2024-04-09,100,,NOP,L 100-110,240,40,85,.471,27,47,.574,13,38,.342,7,8,.875,100,36,87,.414,25,51,.490,11,36,.306,27,29,.931,110
2117,SAC,2024-04-05,100,@,BOS,L 100-101,240,38,99,.384,21,48,.438,17,51,.333,7,13,.538,100,38,89,.427,26,45,.578,12,44,.273,13,18,.722,101
2118,NYK,2024-04-05,100,@,CHI,L 100-108,240,36,83,.434,26,54,.481,10,29,.345,18,24,.750,100,44,93,.473,37,70,.529,7,23,.304,13,16,.813,108
2119,DEN,2024-04-04,100,@,LAC,L 100-102,240,36,83,.434,25,48,.521,11,35,.314,17,25,.680,100,34,90,.378,27,57,.474,7,33,.212,27,32,.844,102
2120,OKC,2024-04-03,100,@,BOS,L 100-135,240,35,81,.432,30,57,.526,5,24,.208,25,28,.893,100,50,92,.543,33,52,.635,17,40,.425,18,19,.947,135
2121,DAL,2024-04-02,100,@,GSW,L 100-104,240,39,89,.438,24,49,.490,15,40,.375,7,11,.636,100,41,90,.456,26,58,.448,15,32,.469,7,7,1.000,104
2122,UTA,2024-03-29,100,,HOU,L 100-101,240,37,80,.463,29,49,.592,8,31,.258,18,19,.947,100,35,91,.385,22,49,.449,13,42,.310,18,28,.643,101
2123,LAC,2024-03-29,100,@,ORL,W 100-97,240,41,85,.482,33,61,.541,8,24,.333,10,12,.833,100,38,86,.442,28,57,.491,10,29,.345,11,15,.733,97
2124,MIL,2024-03-28,100,@,NOP,L 100-107,240,38,82,.463,24,43,.558,14,39,.359,10,19,.526,100,36,91,.396,28,59,.475,8,32,.250,27,34,.794,107
2125,NYK,2024-03-21,100,@,DEN,L 100-113,240,38,79,.481,27,48,.563,11,31,.355,13,17,.765,100,45,84,.536,39,64,.609,6,20,.300,17,20,.850,113
2126,BRK,2024-03-16,100,@,IND,L 100-121,240,33,77,.429,23,52,.442,10,25,.400,24,31,.774,100,50,105,.476,44,75,.587,6,30,.200,15,16,.938,121
2127,UTA,2024-03-16,100,,MIN,L 100-119,240,38,83,.458,32,57,.561,6,26,.231,18,21,.857,100,44,93,.473,25,52,.481,19,41,.463,12,15,.800,119
2128,DEN,2024-03-13,100,@,MIA,W 100-88,240,40,82,.488,29,49,.592,11,33,.333,9,13,.692,100,34,80,.425,29,59,.492,5,21,.238,15,18,.833,88
2129,LAC,2024-03-12,100,,MIN,L 100-118,240,34,72,.472,23,42,.548,11,30,.367,21,25,.840,100,48,94,.511,36,61,.590,12,33,.364,10,14,.714,118
2130,MIA,2024-03-08,100,@,OKC,L 100-107,240,38,82,.463,27,53,.509,11,29,.379,13,18,.722,100,42,89,.472,30,51,.588,12,38,.316,11,13,.846,107
2131,CHO,2024-03-08,100,@,WAS,L 100-112,240,40,100,.400,31,58,.534,9,42,.214,11,15,.733,100,43,87,.494,37,54,.685,6,33,.182,20,23,.870,112
2132,NYK,2024-03-05,100,,ATL,L 100-116,240,38,99,.384,22,47,.468,16,52,.308,8,11,.727,100,44,87,.506,34,56,.607,10,31,.323,18,23,.783,116
2133,MEM,2024-03-02,100,,POR,L 100-107 (OT),265,30,83,.361,15,43,.349,15,40,.375,25,33,.758,100,39,92,.424,28,57,.491,11,35,.314,18,24,.750,107
2134,DET,2024-03-01,100,,CLE,L 100-110,240,33,89,.371,23,53,.434,10,36,.278,24,28,.857,100,33,83,.398,15,42,.357,18,41,.439,26,30,.867,110
2135,DET,2024-02-14,100,@,PHO,L 100-116,240,38,99,.384,28,62,.452,10,37,.270,14,22,.636,100,35,77,.455,25,46,.543,10,31,.323,36,44,.818,116
2136,NYK,2024-02-14,100,@,ORL,L 100-118,240,35,84,.417,24,55,.436,11,29,.379,19,24,.792,100,48,76,.632,36,50,.720,12,26,.462,10,11,.909,118
2137,LAC,2024-02-12,100,,MIN,L 100-121,240,34,84,.405,25,56,.446,9,28,.321,23,26,.885,100,46,86,.535,35,52,.673,11,34,.324,18,19,.947,121
2138,TOR,2024-02-05,100,@,NOP,L 100-138,240,40,84,.476,30,53,.566,10,31,.323,10,15,.667,100,53,104,.510,34,59,.576,19,45,.422,13,13,1.000,138
2139,DEN,2024-01-31,100,@,OKC,L 100-105,240,37,93,.398,22,56,.393,15,37,.405,11,16,.688,100,37,87,.425,26,61,.426,11,26,.423,20,25,.800,105
2140,MIL,2024-01-26,100,,CLE,L 100-112,240,35,87,.402,22,53,.415,13,34,.382,17,24,.708,100,38,92,.413,24,56,.429,14,36,.389,22,31,.710,112
2141,POR,2024-01-26,100,@,SAS,L 100-116,240,38,90,.422,28,53,.528,10,37,.270,14,19,.737,100,42,92,.457,32,58,.552,10,34,.294,22,26,.846,116
2142,TOR,2024-01-22,100,,MEM,L 100-108,240,35,79,.443,27,56,.482,8,23,.348,22,23,.957,100,44,95,.463,31,61,.508,13,34,.382,7,12,.583,108
2143,TOR,2024-01-20,100,@,NYK,L 100-126,240,38,92,.413,27,58,.466,11,34,.324,13,23,.565,100,48,88,.545,34,49,.694,14,39,.359,16,20,.800,126
2144,BOS,2024-01-19,100,,DEN,L 100-102,240,38,89,.427,24,45,.533,14,44,.318,10,14,.714,100,42,81,.519,34,50,.680,8,31,.258,10,13,.769,102
2145,ORL,2024-01-13,100,@,OKC,L 100-112,240,39,84,.464,32,49,.653,7,35,.200,15,24,.625,100,43,94,.457,35,58,.603,8,36,.222,18,21,.857,112
2146,SAC,2024-01-07,100,,NOP,L 100-133,240,38,91,.418,23,46,.500,15,45,.333,9,12,.750,100,50,82,.610,31,47,.660,19,35,.543,14,16,.875,133
2147,CHI,2024-01-03,100,@,NYK,L 100-116,240,37,89,.416,24,57,.421,13,32,.406,13,16,.813,100,46,89,.517,31,51,.608,15,38,.395,9,11,.818,116
2148,CHO,2023-12-06,100,@,CHI,L 100-111,240,39,90,.433,29,53,.547,10,37,.270,12,12,1.000,100,38,90,.422,26,65,.400,12,25,.480,23,29,.793,111
2149,NOP,2023-11-25,100,@,UTA,L 100-105,240,39,93,.419,28,57,.491,11,36,.306,11,18,.611,100,38,87,.437,23,44,.523,15,43,.349,14,17,.824,105
2150,NYK,2023-11-24,100,,MIA,W 100-98,240,39,81,.481,29,52,.558,10,29,.345,12,18,.667,100,34,87,.391,24,50,.480,10,37,.270,20,21,.952,98
2151,NYK,2023-11-20,100,@,MIN,L 100-117,240,32,92,.348,23,54,.426,9,38,.237,27,34,.794,100,41,80,.513,30,46,.652,11,34,.324,24,32,.750,117
2152,CHI,2023-11-20,100,,MIA,L 100-118,240,37,81,.457,26,44,.591,11,37,.297,15,16,.938,100,42,84,.500,25,49,.510,17,35,.486,17,20,.850,118
2153,MEM,2023-11-19,100,,BOS,L 100-102,240,37,95,.389,20,51,.392,17,44,.386,9,10,.900,100,35,77,.455,23,46,.500,12,31,.387,20,25,.800,102
2154,HOU,2023-11-17,100,@,LAC,L 100-106,240,38,88,.432,28,57,.491,10,31,.323,14,20,.700,100,36,83,.434,23,49,.469,13,34,.382,21,30,.700,106
2155,DET,2023-11-17,100,@,CLE,L 100-108,240,39,91,.429,30,56,.536,9,35,.257,13,15,.867,100,42,82,.512,33,61,.541,9,21,.429,15,21,.714,108
2156,BRK,2023-11-08,100,,LAC,W 100-93,240,37,92,.402,22,51,.431,15,41,.366,11,13,.846,100,36,91,.396,28,55,.509,8,36,.222,13,13,1.000,93
2157,POR,2023-11-05,100,,MEM,L 100-112,240,37,95,.389,23,50,.460,14,45,.311,12,15,.800,100,45,89,.506,32,57,.561,13,32,.406,9,13,.692,112
2158,PHO,2023-11-04,100,@,PHI,L 100-112,240,32,89,.360,23,54,.426,9,35,.257,27,33,.818,100,43,90,.478,32,60,.533,11,30,.367,15,18,.833,112
2159,LAL,2023-10-26,100,,PHO,W 100-95,240,36,84,.429,31,55,.564,5,29,.172,23,29,.793,100,34,81,.420,25,50,.500,9,31,.290,18,23,.783,95
2160,ORL,2024-04-10,99,@,MIL,L 99-117,240,36,78,.462,25,48,.521,11,30,.367,16,23,.696,99,43,84,.512,28,44,.636,15,40,.375,16,20,.800,117
2161,NYK,2024-04-02,99,@,MIA,L 99-109,240,35,76,.461,23,42,.548,12,34,.353,17,21,.810,99,36,74,.486,19,36,.528,17,38,.447,20,21,.952,109
2162,IND,2024-03-27,99,@,CHI,L 99-125,240,34,85,.400,21,43,.488,13,42,.310,18,23,.783,99,49,98,.500,37,71,.521,12,27,.444,15,18,.833,125
2163,DET,2024-03-25,99,@,NYK,L 99-124,240,34,88,.386,24,54,.444,10,34,.294,21,22,.955,99,45,89,.506,26,43,.605,19,46,.413,15,22,.682,124
2164,MEM,2024-03-22,99,@,SAS,W 99-97,240,33,82,.402,21,48,.438,12,34,.353,21,31,.677,99,37,95,.389,30,57,.526,7,38,.184,16,23,.696,97
2165,GSW,2024-03-13,99,@,DAL,L 99-109,240,37,92,.402,28,64,.438,9,28,.321,16,19,.842,99,44,82,.537,38,55,.691,6,27,.222,15,19,.789,109
2166,POR,2024-03-11,99,,BOS,L 99-121,240,39,87,.448,29,59,.492,10,28,.357,11,11,1.000,99,49,100,.490,34,60,.567,15,40,.375,8,12,.667,121
2167,BRK,2024-03-09,99,@,CHO,L 99-110,240,36,90,.400,22,48,.458,14,42,.333,13,17,.765,99,44,81,.543,33,51,.647,11,30,.367,11,15,.733,110
2168,ATL,2024-03-08,99,@,MEM,W 99-92,240,37,87,.425,22,52,.423,15,35,.429,10,15,.667,99,30,74,.405,20,48,.417,10,26,.385,22,30,.733,92
2169,CHO,2024-02-29,99,,MIL,L 99-111,240,36,82,.439,24,43,.558,12,39,.308,15,20,.750,99,39,86,.453,23,47,.489,16,39,.410,17,20,.850,111
2170,NYK,2024-02-29,99,,GSW,L 99-110,240,35,95,.368,23,56,.411,12,39,.308,17,24,.708,99,44,98,.449,30,54,.556,14,44,.318,8,16,.500,110
2171,PHI,2024-02-27,99,@,BOS,L 99-117,240,37,94,.394,23,52,.442,14,42,.333,11,12,.917,99,39,74,.527,34,52,.654,5,22,.227,34,37,.919,117
2172,ATL,2024-02-14,99,@,CHO,L 99-122,240,36,89,.404,27,51,.529,9,38,.237,18,20,.900,99,44,89,.494,29,52,.558,15,37,.405,19,20,.950,122
2173,TOR,2024-02-12,99,,SAS,L 99-122,240,39,98,.398,31,67,.463,8,31,.258,13,16,.813,99,46,87,.529,35,57,.614,11,30,.367,19,23,.826,122
2174,CHO,2024-02-04,99,,IND,L 99-115,240,35,88,.398,27,59,.458,8,29,.276,21,25,.840,99,45,92,.489,34,59,.576,11,33,.333,14,18,.778,115
2175,DET,2024-02-04,99,,ORL,L 99-111,240,36,80,.450,28,49,.571,8,31,.258,19,22,.864,99,45,84,.536,35,60,.583,10,24,.417,11,15,.733,111
2176,HOU,2024-01-31,99,,NOP,L 99-110,240,35,87,.402,22,43,.512,13,44,.295,16,17,.941,99,41,82,.500,30,48,.625,11,34,.324,17,24,.708,110
2177,ORL,2024-01-22,99,,CLE,L 99-126,240,34,74,.459,23,45,.511,11,29,.379,20,30,.667,99,45,80,.563,25,42,.595,20,38,.526,16,22,.727,126
2178,SAS,2024-01-15,99,@,ATL,L 99-109,240,38,95,.400,27,53,.509,11,42,.262,12,17,.706,99,40,93,.430,27,55,.491,13,38,.342,16,21,.762,109
2179,ATL,2024-01-13,99,,WAS,L 99-127,240,32,93,.344,21,53,.396,11,40,.275,24,33,.727,99,47,97,.485,35,65,.538,12,32,.375,21,26,.808,127
2180,MIA,2024-01-12,99,,ORL,W 99-96,240,37,83,.446,29,57,.509,8,26,.308,17,20,.850,99,36,82,.439,24,42,.571,12,40,.300,12,20,.600,96
2181,CHO,2024-01-12,99,@,SAS,L 99-135,240,32,89,.360,22,55,.400,10,34,.294,25,28,.893,99,45,87,.517,27,49,.551,18,38,.474,27,34,.794,135
2182,CHO,2023-12-18,99,@,TOR,L 99-114,240,39,89,.438,31,57,.544,8,32,.250,13,13,1.000,99,44,86,.512,36,57,.632,8,29,.276,18,22,.818,114
2183,SAC,2023-12-12,99,@,LAC,L 99-119,240,36,86,.419,26,49,.531,10,37,.270,17,24,.708,99,44,84,.524,33,55,.600,11,29,.379,20,21,.952,119
2184,MIA,2023-12-08,99,,CLE,L 99-111,240,37,86,.430,22,44,.500,15,42,.357,10,15,.667,99,40,87,.460,26,49,.531,14,38,.368,17,26,.654,111
2185,PHI,2023-11-22,99,@,MIN,L 99-112,240,34,87,.391,27,55,.491,7,32,.219,24,30,.800,99,43,89,.483,33,63,.524,10,26,.385,16,24,.667,112
2186,UTA,2023-11-21,99,@,LAL,L 99-131,240,38,98,.388,27,54,.500,11,44,.250,12,16,.750,99,49,86,.570,38,57,.667,11,29,.379,22,27,.815,131
2187,SAS,2023-11-20,99,,LAC,L 99-124,240,39,90,.433,29,52,.558,10,38,.263,11,14,.786,99,45,95,.474,33,59,.559,12,36,.333,22,25,.880,124
2188,BRK,2023-11-19,99,,PHI,L 99-121,240,38,81,.469,27,53,.509,11,28,.393,12,16,.750,99,44,94,.468,28,59,.475,16,35,.457,17,18,.944,121
2189,WAS,2023-11-17,99,,NYK,L 99-120,240,37,82,.451,27,50,.540,10,32,.313,15,16,.938,99,45,91,.495,29,53,.547,16,38,.421,14,20,.700,120
2190,CHO,2023-11-17,99,,MIL,L 99-130,240,37,91,.407,31,65,.477,6,26,.231,19,22,.864,99,49,89,.551,27,44,.614,22,45,.489,10,13,.769,130
2191,POR,2023-11-14,99,@,UTA,L 99-115,240,37,88,.420,26,53,.491,11,35,.314,14,20,.700,99,44,95,.463,31,52,.596,13,43,.302,14,15,.933,115
2192,PHO,2023-11-12,99,,OKC,L 99-111,240,32,83,.386,23,54,.426,9,29,.310,26,31,.839,99,40,82,.488,30,55,.545,10,27,.370,21,25,.840,111
2193,TOR,2023-11-02,99,@,PHI,L 99-114,240,38,79,.481,28,51,.549,10,28,.357,13,19,.684,99,42,92,.457,33,67,.493,9,25,.360,21,25,.840,114
2194,POR,2023-10-30,99,@,TOR,W 99-91,240,38,85,.447,27,50,.540,11,35,.314,12,15,.800,99,38,94,.404,34,65,.523,4,29,.138,11,15,.733,91
2195,CHO,2023-10-27,99,,DET,L 99-111,240,33,88,.375,26,60,.433,7,28,.250,26,34,.765,99,40,88,.455,30,58,.517,10,30,.333,21,25,.840,111
2196,CHO,2024-04-12,98,@,BOS,L 98-131,240,32,76,.421,17,41,.415,15,35,.429,19,22,.864,98,54,104,.519,40,63,.635,14,41,.341,9,13,.692,131
2197,MEM,2024-04-10,98,@,CLE,L 98-110,240,33,84,.393,19,52,.365,14,32,.438,18,19,.947,98,37,82,.451,22,45,.489,15,37,.405,21,29,.724,110
2198,CHI,2024-04-07,98,@,ORL,L 98-113,240,38,75,.507,32,55,.582,6,20,.300,16,22,.727,98,42,90,.467,31,56,.554,11,34,.324,18,19,.947,113
2199,DEN,2024-03-29,98,,MIN,L 98-111,240,35,88,.398,27,60,.450,8,28,.286,20,27,.741,98,38,74,.514,29,46,.630,9,28,.321,26,37,.703,111
2200,PHI,2024-03-18,98,,MIA,W 98-91,240,37,85,.435,24,49,.490,13,36,.361,11,12,.917,98,35,89,.393,23,56,.411,12,33,.364,9,14,.643,91
2201,WAS,2024-03-16,98,@,CHI,L 98-127,240,36,84,.429,23,52,.442,13,32,.406,13,22,.591,98,49,85,.576,41,61,.672,8,24,.333,21,29,.724,127
2202,CHO,2024-03-16,98,@,PHI,L 98-109,240,37,82,.451,27,51,.529,10,31,.323,14,18,.778,98,36,81,.444,23,40,.575,13,41,.317,24,25,.960,109
2203,NYK,2024-03-16,98,@,SAC,W 98-91,240,37,86,.430,26,47,.553,11,39,.282,13,16,.813,98,30,85,.353,20,48,.417,10,37,.270,21,26,.808,91
2204,MEM,2024-03-13,98,,CHO,L 98-110,240,36,85,.424,20,45,.444,16,40,.400,10,11,.909,98,44,82,.537,31,46,.674,13,36,.361,9,13,.692,110
2205,NYK,2024-03-08,98,,ORL,W 98-74,240,38,79,.481,22,46,.478,16,33,.485,6,8,.750,98,27,79,.342,21,53,.396,6,26,.231,14,20,.700,74
2206,TOR,2024-03-05,98,,NOP,L 98-139,240,36,93,.387,23,49,.469,13,44,.295,13,22,.591,98,53,105,.505,29,56,.518,24,49,.490,9,11,.818,139
2207,CLE,2024-03-03,98,,NYK,L 98-107,240,39,87,.448,22,43,.512,17,44,.386,3,8,.375,98,42,86,.488,26,47,.553,16,39,.410,7,10,.700,107
2208,PHI,2024-02-25,98,,MIL,L 98-119,240,36,97,.371,20,51,.392,16,46,.348,10,11,.909,98,43,79,.544,25,42,.595,18,37,.486,15,18,.833,119
2209,DEN,2024-02-14,98,,SAC,L 98-102,240,35,89,.393,26,63,.413,9,26,.346,19,22,.864,98,39,89,.438,30,56,.536,9,33,.273,15,19,.789,102
2210,BRK,2024-02-05,98,,GSW,L 98-109,240,34,89,.382,21,47,.447,13,42,.310,17,22,.773,98,43,93,.462,39,71,.549,4,22,.182,19,23,.826,109
2211,SAS,2024-01-31,98,,ORL,L 98-108,240,36,80,.450,27,49,.551,9,31,.290,17,24,.708,98,41,86,.477,34,66,.515,7,20,.350,19,23,.826,108
2212,PHO,2024-01-28,98,@,ORL,L 98-113,240,41,73,.562,37,59,.627,4,14,.286,12,21,.571,98,41,92,.446,29,56,.518,12,36,.333,19,26,.731,113
2213,SAS,2024-01-17,98,@,BOS,L 98-117,240,39,93,.419,32,59,.542,7,34,.206,13,16,.813,98,42,90,.467,24,52,.462,18,38,.474,15,19,.789,117
2214,ORL,2024-01-15,98,@,NYK,W 98-94,240,38,85,.447,30,56,.536,8,29,.276,14,21,.667,98,33,83,.398,20,43,.465,13,40,.325,15,22,.682,94
2215,CHO,2024-01-10,98,,SAC,L 98-123,240,35,87,.402,19,49,.388,16,38,.421,12,16,.750,98,46,89,.517,33,54,.611,13,35,.371,18,23,.783,123
2216,SAS,2024-01-02,98,@,MEM,L 98-106,240,36,85,.424,26,54,.481,10,31,.323,16,23,.696,98,37,80,.463,25,42,.595,12,38,.316,20,25,.800,106
2217,SAC,2023-12-23,98,,MIN,L 98-110,240,37,85,.435,29,52,.558,8,33,.242,16,21,.762,98,44,87,.506,34,54,.630,10,33,.303,12,14,.857,110
2218,MIA,2023-11-24,98,@,NYK,L 98-100,240,34,87,.391,24,50,.480,10,37,.270,20,21,.952,98,39,81,.481,29,52,.558,10,29,.345,12,18,.667,100
2219,NYK,2023-11-13,98,@,BOS,L 98-114,240,33,79,.418,18,44,.409,15,35,.429,17,24,.708,98,40,79,.506,21,36,.583,19,43,.442,15,16,.938,114
2220,OKC,2023-11-10,98,@,SAC,L 98-105,240,39,87,.448,32,57,.561,7,30,.233,13,16,.813,98,38,91,.418,25,44,.568,13,47,.277,16,21,.762,105
2221,POR,2023-10-29,98,@,PHI,L 98-126,240,36,94,.383,29,63,.460,7,31,.226,19,22,.864,98,40,82,.488,29,54,.537,11,28,.393,35,40,.875,126
2222,CLE,2024-04-06,97,@,LAL,L 97-116,240,39,90,.433,28,55,.509,11,35,.314,8,12,.667,97,45,80,.563,29,43,.674,16,37,.432,10,16,.625,116
2223,PHO,2024-04-05,97,,MIN,W 97-87,240,33,76,.434,24,50,.480,9,26,.346,22,29,.759,97,33,85,.388,23,56,.411,10,29,.345,11,14,.786,87
2224,CHO,2024-03-29,97,,GSW,L 97-115,240,34,84,.405,22,38,.579,12,46,.261,17,24,.708,97,48,89,.539,37,57,.649,11,32,.344,8,9,.889,115
2225,ORL,2024-03-29,97,,LAC,L 97-100,240,38,86,.442,28,57,.491,10,29,.345,11,15,.733,97,41,85,.482,33,61,.541,8,24,.333,10,12,.833,100
2226,DEN,2024-03-27,97,,PHO,L 97-104,240,38,88,.432,28,48,.583,10,40,.250,11,12,.917,97,39,83,.470,23,50,.460,16,33,.485,10,11,.909,104
2227,SAS,2024-03-22,97,,MEM,L 97-99,240,37,95,.389,30,57,.526,7,38,.184,16,23,.696,97,33,82,.402,21,48,.438,12,34,.353,21,31,.677,99
2228,UTA,2024-03-21,97,@,DAL,L 97-113,240,38,83,.458,34,53,.642,4,30,.133,17,19,.895,97,43,86,.500,33,54,.611,10,32,.313,17,28,.607,113
2229,WAS,2024-03-12,97,@,MEM,L 97-109,240,37,82,.451,26,46,.565,11,36,.306,12,16,.750,97,42,94,.447,34,61,.557,8,33,.242,17,21,.810,109
2230,CHO,2024-03-11,97,@,DET,L 97-114,240,34,88,.386,21,48,.438,13,40,.325,16,23,.696,97,41,86,.477,31,44,.705,10,42,.238,22,24,.917,114
2231,ORL,2024-03-10,97,,IND,L 97-111,240,33,88,.375,24,52,.462,9,36,.250,22,29,.759,97,38,78,.487,30,55,.545,8,23,.348,27,33,.818,111
2232,CHI,2024-03-01,97,,MIL,L 97-113,240,36,86,.419,25,59,.424,11,27,.407,14,16,.875,97,37,86,.430,22,40,.550,15,46,.326,24,32,.750,113
2233,ATL,2024-02-29,97,@,BRK,L 97-124,240,37,86,.430,29,58,.500,8,28,.286,15,21,.714,97,46,90,.511,24,44,.545,22,46,.478,10,13,.769,124
2234,MIA,2024-02-29,97,@,DEN,L 97-103,240,35,83,.422,28,57,.491,7,26,.269,20,24,.833,97,36,84,.429,24,50,.480,12,34,.353,19,21,.905,103
2235,UTA,2024-02-27,97,@,ATL,L 97-124,240,35,94,.372,24,56,.429,11,38,.289,16,19,.842,97,46,93,.495,34,61,.557,12,32,.375,20,23,.870,124
2236,CLE,2024-02-23,97,@,PHI,L 97-104,240,34,80,.425,26,53,.491,8,27,.296,21,31,.677,97,40,90,.444,28,61,.459,12,29,.414,12,15,.800,104
2237,GSW,2024-02-23,97,,CHO,W 97-84,240,38,89,.427,25,47,.532,13,42,.310,8,10,.800,97,32,88,.364,21,49,.429,11,39,.282,9,11,.818,84
2238,MIL,2024-02-13,97,,MIA,L 97-123,240,37,83,.446,24,44,.545,13,39,.333,10,11,.909,97,45,87,.517,26,47,.553,19,40,.475,14,18,.778,123
2239,PHI,2024-01-20,97,@,CHO,W 97-89,240,36,85,.424,31,60,.517,5,25,.200,20,24,.833,97,35,85,.412,26,48,.542,9,37,.243,10,14,.714,89
2240,MIN,2024-01-20,97,,OKC,L 97-102,240,31,75,.413,17,38,.447,14,37,.378,21,29,.724,97,32,81,.395,24,57,.421,8,24,.333,30,35,.857,102
2241,MIA,2024-01-17,97,@,TOR,L 97-121,240,41,90,.456,35,62,.565,6,28,.214,9,12,.750,97,45,88,.511,25,50,.500,20,38,.526,11,18,.611,121
2242,MIA,2024-01-05,97,@,PHO,L 97-113,240,34,83,.410,24,46,.522,10,37,.270,19,22,.864,97,44,87,.506,30,52,.577,14,35,.400,11,17,.647,113
2243,UTA,2024-01-05,97,@,BOS,L 97-126,240,34,94,.362,28,60,.467,6,34,.176,23,34,.676,97,39,90,.433,22,41,.537,17,49,.347,31,36,.861,126
2244,POR,2024-01-03,97,@,DAL,L 97-126,240,34,87,.391,21,47,.447,13,40,.325,16,22,.727,97,42,84,.500,29,54,.537,13,30,.433,29,41,.707,126
2245,CHI,2024-01-02,97,@,PHI,L 97-110,240,37,96,.385,30,59,.508,7,37,.189,16,23,.696,97,38,80,.475,26,50,.520,12,30,.400,22,30,.733,110
2246,MEM,2023-12-18,97,@,OKC,L 97-116,240,30,85,.353,11,31,.355,19,54,.352,18,21,.857,97,42,92,.457,31,56,.554,11,36,.306,21,23,.913,116
2247,ORL,2023-12-17,97,@,BOS,L 97-114,240,34,89,.382,23,53,.434,11,36,.306,18,24,.750,97,45,95,.474,28,59,.475,17,36,.472,7,8,.875,114
2248,WAS,2023-12-08,97,@,BRK,L 97-124,240,38,91,.418,32,58,.552,6,33,.182,15,21,.714,97,50,104,.481,40,71,.563,10,33,.303,14,18,.778,124
2249,UTA,2023-12-06,97,@,DAL,L 97-147,240,35,87,.402,23,54,.426,12,33,.364,15,18,.833,97,56,101,.554,34,52,.654,22,49,.449,13,19,.684,147
2250,HOU,2023-12-02,97,@,LAL,L 97-107,240,36,89,.404,25,58,.431,11,31,.355,14,18,.778,97,40,89,.449,32,62,.516,8,27,.296,19,27,.704,107
2251,CHI,2023-11-28,97,@,BOS,L 97-124,240,39,90,.433,30,62,.484,9,28,.321,10,18,.556,97,47,90,.522,26,41,.634,21,49,.429,9,12,.750,124
2252,MEM,2023-11-26,97,,MIN,L 97-119,240,34,88,.386,24,51,.471,10,37,.270,19,27,.704,97,43,81,.531,28,47,.596,15,34,.441,18,23,.783,119
2253,MIA,2023-11-25,97,@,BRK,L 97-112,240,38,87,.437,27,53,.509,11,34,.324,10,13,.769,97,39,78,.500,25,42,.595,14,36,.389,20,23,.870,112
2254,MIA,2023-11-18,97,@,CHI,L 97-102,240,33,77,.429,21,41,.512,12,36,.333,19,23,.826,97,36,81,.444,20,36,.556,16,45,.356,14,19,.737,102
2255,CHI,2023-11-17,97,,ORL,L 97-103,240,35,79,.443,25,50,.500,10,29,.345,17,22,.773,97,38,79,.481,27,45,.600,11,34,.324,16,23,.696,103
2256,MIL,2023-11-11,97,@,ORL,L 97-112,240,38,77,.494,29,48,.604,9,29,.310,12,25,.480,97,36,84,.429,26,58,.448,10,26,.385,30,35,.857,112
2257,LAC,2023-11-06,97,@,NYK,L 97-111,240,36,73,.493,25,41,.610,11,32,.344,14,16,.875,97,41,88,.466,29,57,.509,12,31,.387,17,18,.944,111
2258,SAC,2023-11-06,97,@,HOU,L 97-122,240,36,81,.444,22,41,.537,14,40,.350,11,20,.550,97,43,75,.573,28,44,.636,15,31,.484,21,27,.778,122
2259,POR,2023-10-27,97,,ORL,L 97-102,240,35,88,.398,26,56,.464,9,32,.281,18,21,.857,97,36,79,.456,27,51,.529,9,28,.321,21,32,.656,102
2260,TOR,2023-10-25,97,,MIN,W 97-94,240,36,90,.400,22,55,.400,14,35,.400,11,16,.688,97,34,100,.340,26,69,.377,8,31,.258,18,22,.818,94
2261,MEM,2024-04-06,96,,PHI,L 96-116,240,36,87,.414,27,61,.443,9,26,.346,15,21,.714,96,41,79,.519,25,40,.625,16,39,.410,18,23,.783,116
2262,DET,2024-03-29,96,@,WAS,W 96-87,240,37,89,.416,31,65,.477,6,24,.250,16,20,.800,96,36,88,.409,27,55,.491,9,33,.273,6,8,.750,87
2263,SAC,2024-03-26,96,,DAL,L 96-132,240,35,90,.389,24,60,.400,11,30,.367,15,19,.789,96,51,92,.554,29,53,.547,22,39,.564,8,13,.615,132
2264,BRK,2024-03-25,96,@,TOR,W 96-88,240,37,81,.457,28,42,.667,9,39,.231,13,18,.722,96,37,85,.435,32,58,.552,5,27,.185,9,12,.750,88
2265,PHI,2024-03-25,96,@,SAC,L 96-108,240,34,82,.415,23,48,.479,11,34,.324,17,20,.850,96,38,86,.442,28,48,.583,10,38,.263,22,28,.786,108
2266,TOR,2024-03-17,96,@,ORL,L 96-111,240,37,84,.440,29,53,.547,8,31,.258,14,15,.933,96,43,85,.506,32,49,.653,11,36,.306,14,20,.700,111
2267,CHO,2024-03-15,96,,PHO,L 96-107,240,35,94,.372,29,57,.509,6,37,.162,20,27,.741,96,40,87,.460,29,49,.592,11,38,.289,16,20,.800,107
2268,SAC,2024-02-28,96,@,DEN,L 96-117,240,38,95,.400,26,60,.433,12,35,.343,8,13,.615,96,46,86,.535,31,51,.608,15,35,.429,10,11,.909,117
2269,POR,2024-02-27,96,,MIA,L 96-106,240,35,86,.407,25,55,.455,10,31,.323,16,19,.842,96,37,70,.529,23,44,.523,14,26,.538,18,26,.692,106
2270,PHI,2024-02-22,96,,NYK,L 96-110,240,37,84,.440,27,55,.491,10,29,.345,12,14,.857,96,38,79,.481,23,45,.511,15,34,.441,19,27,.704,110
2271,NOP,2024-02-12,96,@,MEM,W 96-87,240,32,78,.410,19,43,.442,13,35,.371,19,24,.792,96,34,81,.420,22,37,.595,12,44,.273,7,8,.875,87
2272,POR,2024-01-28,96,,CHI,L 96-104,240,32,79,.405,26,46,.565,6,33,.182,26,29,.897,96,42,90,.467,34,58,.586,8,32,.250,12,17,.706,104
2273,BOS,2024-01-27,96,,LAC,L 96-115,240,36,100,.360,26,60,.433,10,40,.250,14,16,.875,96,45,102,.441,35,62,.565,10,40,.250,15,18,.833,115
2274,MIN,2024-01-25,96,@,BRK,W 96-94,240,37,75,.493,27,54,.500,10,21,.476,12,16,.750,96,35,77,.455,25,44,.568,10,33,.303,14,16,.875,94
2275,MIA,2024-01-24,96,,MEM,L 96-105,240,33,82,.402,22,48,.458,11,34,.324,19,25,.760,96,36,80,.450,19,44,.432,17,36,.472,16,19,.842,105
2276,MEM,2024-01-20,96,@,CHI,L 96-125,240,32,75,.427,19,33,.576,13,42,.310,19,23,.826,96,47,91,.516,33,58,.569,14,33,.424,17,21,.810,125
2277,MIA,2024-01-15,96,@,BRK,W 96-95 (OT),265,33,87,.379,25,56,.446,8,31,.258,22,25,.880,96,34,99,.343,22,44,.500,12,55,.218,15,16,.938,95
2278,TOR,2024-01-15,96,,BOS,L 96-105,240,38,95,.400,34,63,.540,4,32,.125,16,21,.762,96,33,82,.402,17,43,.395,16,39,.410,23,25,.920,105
2279,ORL,2024-01-12,96,@,MIA,L 96-99,240,36,82,.439,24,42,.571,12,40,.300,12,20,.600,96,37,83,.446,29,57,.509,8,26,.308,17,20,.850,99
2280,LAL,2024-01-03,96,,MIA,L 96-110,240,35,83,.422,31,53,.585,4,30,.133,22,24,.917,96,41,93,.441,25,51,.490,16,42,.381,12,17,.706,110
2281,DAL,2023-12-22,96,@,HOU,L 96-122,240,35,101,.347,28,61,.459,7,40,.175,19,26,.731,96,46,95,.484,35,57,.614,11,38,.289,19,23,.826,122
2282,MEM,2023-12-15,96,,HOU,L 96-103,240,37,92,.402,26,52,.500,11,40,.275,11,15,.733,96,32,88,.364,21,59,.356,11,29,.379,28,32,.875,103
2283,BOS,2023-11-24,96,@,ORL,L 96-113,240,31,76,.408,24,47,.511,7,29,.241,27,37,.730,96,43,85,.506,32,57,.561,11,28,.393,16,22,.727,113
2284,CLE,2023-11-22,96,,MIA,L 96-129,240,36,77,.468,22,47,.468,14,30,.467,10,14,.714,96,46,88,.523,26,53,.491,20,35,.571,17,21,.810,129
2285,ORL,2023-11-15,96,@,CHI,W 96-94,240,32,82,.390,24,54,.444,8,28,.286,24,30,.800,96,33,83,.398,24,50,.480,9,33,.273,19,22,.864,94
2286,NOP,2023-10-28,96,,NYK,W 96-87,240,40,87,.460,31,54,.574,9,33,.273,7,16,.438,96,33,90,.367,26,53,.491,7,37,.189,14,18,.778,87
2287,DET,2024-04-14,95,@,SAS,L 95-123,240,36,92,.391,28,59,.475,8,33,.242,15,20,.750,95,49,91,.538,34,57,.596,15,34,.441,10,14,.714,123
2288,UTA,2024-04-09,95,,DEN,L 95-111,240,36,91,.396,26,60,.433,10,31,.323,13,13,1.000,95,46,94,.489,32,57,.561,14,37,.378,5,11,.455,111
2289,ATL,2024-04-04,95,@,DAL,L 95-109,240,34,85,.400,21,47,.447,13,38,.342,14,21,.667,95,38,94,.404,20,45,.444,18,49,.367,15,17,.882,109
2290,LAC,2024-04-02,95,@,SAC,L 95-109,240,31,76,.408,20,49,.408,11,27,.407,22,27,.815,95,39,92,.424,27,50,.540,12,42,.286,19,25,.760,109
2291,DET,2024-03-15,95,,MIA,L 95-108,240,36,84,.429,26,46,.565,10,38,.263,13,15,.867,95,43,91,.473,36,57,.632,7,34,.206,15,21,.714,108
2292,NOP,2024-03-13,95,,CLE,L 95-116,240,35,80,.438,31,58,.534,4,22,.182,21,26,.808,95,47,92,.511,27,47,.574,20,45,.444,2,3,.667,116
2293,PHI,2024-03-08,95,,NOP,L 95-103,240,35,88,.398,26,51,.510,9,37,.243,16,20,.800,95,35,79,.443,24,48,.500,11,31,.355,22,23,.957,103
2294,CHI,2024-02-27,95,,DET,L 95-105,240,39,98,.398,37,69,.536,2,29,.069,15,18,.833,95,37,75,.493,23,38,.605,14,37,.378,17,23,.739,105
2295,HOU,2024-02-27,95,@,OKC,L 95-112,240,37,95,.389,28,56,.500,9,39,.231,12,18,.667,95,44,93,.473,34,66,.515,10,27,.370,14,18,.778,112
2296,MEM,2024-02-23,95,,LAC,L 95-101,240,38,91,.418,30,56,.536,8,35,.229,11,16,.688,95,37,84,.440,25,52,.481,12,32,.375,15,17,.882,101
2297,NOP,2024-02-23,95,,MIA,L 95-106,240,39,104,.375,32,72,.444,7,32,.219,10,13,.769,95,38,82,.463,25,53,.472,13,29,.448,17,25,.680,106
2298,DEN,2024-02-12,95,@,MIL,L 95-112,240,36,94,.383,25,54,.463,11,40,.275,12,17,.706,95,42,84,.500,26,50,.520,16,34,.471,12,18,.667,112
2299,TOR,2024-02-10,95,,CLE,L 95-119,240,35,87,.402,26,56,.464,9,31,.290,16,23,.696,95,48,92,.522,34,51,.667,14,41,.341,9,13,.692,119
2300,BRK,2024-02-08,95,,CLE,L 95-118,240,37,93,.398,27,68,.397,10,25,.400,11,14,.786,95,43,80,.538,28,43,.651,15,37,.405,17,17,1.000,118
2301,ORL,2024-02-06,95,@,MIA,L 95-121,240,35,80,.438,25,45,.556,10,35,.286,15,21,.714,95,47,87,.540,34,51,.667,13,36,.361,14,18,.778,121
2302,MIA,2024-02-04,95,,LAC,L 95-103,240,38,91,.418,30,61,.492,8,30,.267,11,12,.917,95,34,77,.442,18,38,.474,16,39,.410,19,22,.864,103
2303,ATL,2024-01-20,95,,CLE,L 95-116,240,37,93,.398,26,55,.473,11,38,.289,10,15,.667,95,43,85,.506,27,42,.643,16,43,.372,14,16,.875,116
2304,MIL,2024-01-17,95,@,CLE,L 95-135,240,38,95,.400,26,53,.491,12,42,.286,7,10,.700,95,55,93,.591,43,65,.662,12,28,.429,13,19,.684,135
2305,BRK,2024-01-15,95,,MIA,L 95-96 (OT),265,34,99,.343,22,44,.500,12,55,.218,15,16,.938,95,33,87,.379,25,56,.446,8,31,.258,22,25,.880,96
2306,NOP,2024-01-05,95,,LAC,L 95-111,240,33,92,.359,21,63,.333,12,29,.414,17,23,.739,95,40,82,.488,25,46,.543,15,36,.417,16,20,.800,111
2307,HOU,2024-01-05,95,,MIN,L 95-122,240,36,90,.400,24,58,.414,12,32,.375,11,15,.733,95,46,88,.523,32,55,.582,14,33,.424,16,20,.800,122
2308,CHO,2023-12-23,95,,DEN,L 95-102,240,34,88,.386,26,60,.433,8,28,.286,19,23,.826,95,39,90,.433,27,60,.450,12,30,.400,12,14,.857,102
2309,CHI,2023-12-23,95,,CLE,L 95-109,240,35,80,.438,27,45,.600,8,35,.229,17,19,.895,95,39,88,.443,27,43,.628,12,45,.267,19,26,.731,109
2310,SAS,2023-12-21,95,@,CHI,L 95-114,240,37,81,.457,27,51,.529,10,30,.333,11,16,.688,95,49,90,.544,42,62,.677,7,28,.250,9,11,.818,114
2311,CLE,2023-11-30,95,,POR,L 95-103,240,38,89,.427,31,57,.544,7,32,.219,12,12,1.000,95,39,77,.506,25,42,.595,14,35,.400,11,11,1.000,103
2312,POR,2023-11-17,95,,LAL,L 95-107,240,36,89,.404,26,52,.500,10,37,.270,13,18,.722,95,40,81,.494,28,52,.538,12,29,.414,15,22,.682,107
2313,POR,2023-11-15,95,,CLE,L 95-109,240,34,91,.374,21,53,.396,13,38,.342,14,16,.875,95,42,75,.560,33,45,.733,9,30,.300,16,21,.762,109
2314,UTA,2023-11-04,95,@,MIN,L 95-123,240,35,91,.385,23,48,.479,12,43,.279,13,17,.765,95,45,81,.556,36,57,.632,9,24,.375,24,31,.774,123
2315,CLE,2023-11-01,95,@,NYK,W 95-89,240,32,74,.432,20,42,.476,12,32,.375,19,20,.950,95,32,92,.348,27,62,.435,5,30,.167,20,30,.667,89
2316,OKC,2023-10-29,95,,DEN,L 95-128,240,37,90,.411,31,58,.534,6,32,.188,15,18,.833,95,53,88,.602,42,61,.689,11,27,.407,11,13,.846,128
2317,HOU,2023-10-29,95,,GSW,L 95-106,240,34,90,.378,25,57,.439,9,33,.273,18,19,.947,95,35,81,.432,17,36,.472,18,45,.400,18,23,.783,106
2318,PHO,2023-10-26,95,@,LAL,L 95-100,240,34,81,.420,25,50,.500,9,31,.290,18,23,.783,95,36,84,.429,31,55,.564,5,29,.172,23,29,.793,100
2319,PHI,2024-03-22,94,@,LAL,L 94-101,240,33,96,.344,25,59,.424,8,37,.216,20,24,.833,94,32,73,.438,20,42,.476,12,31,.387,25,33,.758,101
2320,DET,2024-03-18,94,@,BOS,L 94-119,240,36,84,.429,27,55,.491,9,29,.310,13,15,.867,94,43,95,.453,21,46,.457,22,49,.449,11,13,.846,119
2321,MIL,2024-03-12,94,@,SAC,L 94-129,240,30,82,.366,23,43,.535,7,39,.179,27,35,.771,94,49,92,.533,31,52,.596,18,40,.450,13,16,.813,129
2322,MEM,2024-01-29,94,,SAC,L 94-103,240,30,80,.375,17,44,.386,13,36,.361,21,28,.750,94,43,84,.512,32,46,.696,11,38,.289,6,10,.600,103
2323,BRK,2024-01-25,94,,MIN,L 94-96,240,35,77,.455,25,44,.568,10,33,.303,14,16,.875,94,37,75,.493,27,54,.500,10,21,.476,12,16,.750,96
2324,HOU,2024-01-17,94,@,NYK,L 94-109,240,35,84,.417,27,54,.500,8,30,.267,16,19,.842,94,39,87,.448,26,50,.520,13,37,.351,18,22,.818,109
2325,NYK,2024-01-15,94,,ORL,L 94-98,240,33,83,.398,20,43,.465,13,40,.325,15,22,.682,94,38,85,.447,30,56,.536,8,29,.276,14,21,.667,98
2326,MEM,2024-01-13,94,,NYK,L 94-106,240,36,87,.414,27,49,.551,9,38,.237,13,15,.867,94,40,83,.482,27,45,.600,13,38,.342,13,19,.684,106
2327,CLE,2023-12-11,94,@,ORL,L 94-104,240,30,85,.353,21,45,.467,9,40,.225,25,33,.758,94,39,84,.464,32,58,.552,7,26,.269,19,25,.760,104
2328,SAS,2023-12-06,94,@,MIN,L 94-102,240,38,101,.376,30,65,.462,8,36,.222,10,15,.667,94,36,87,.414,24,47,.511,12,40,.300,18,21,.857,102
2329,DAL,2023-12-01,94,,MEM,L 94-108,240,34,92,.370,22,53,.415,12,39,.308,14,21,.667,94,44,90,.489,33,56,.589,11,34,.324,9,11,.818,108
2330,LAL,2023-11-27,94,@,PHI,L 94-138,240,39,83,.470,32,55,.582,7,28,.250,9,13,.692,94,47,93,.505,25,47,.532,22,46,.478,22,26,.846,138
2331,CHI,2023-11-15,94,,ORL,L 94-96,240,33,83,.398,24,50,.480,9,33,.273,19,22,.864,94,32,82,.390,24,54,.444,8,28,.286,24,30,.800,96
2332,WAS,2023-11-12,94,@,BRK,L 94-102,240,33,88,.375,23,47,.489,10,41,.244,18,25,.720,94,37,98,.378,25,49,.510,12,49,.245,16,20,.800,102
2333,TOR,2023-11-11,94,@,BOS,L 94-117,240,35,91,.385,25,54,.463,10,37,.270,14,16,.875,94,47,86,.547,32,42,.762,15,44,.341,8,13,.615,117
2334,LAL,2023-11-08,94,@,HOU,L 94-128,240,36,85,.424,29,60,.483,7,25,.280,15,24,.625,94,51,93,.548,37,60,.617,14,33,.424,12,19,.632,128
2335,MIN,2023-10-25,94,@,TOR,L 94-97,240,34,100,.340,26,69,.377,8,31,.258,18,22,.818,94,36,90,.400,22,55,.400,14,35,.400,11,16,.688,97
2336,ORL,2024-03-27,93,,GSW,L 93-101,240,36,85,.424,26,53,.491,10,32,.313,11,21,.524,93,40,90,.444,30,56,.536,10,34,.294,11,13,.846,101
2337,OKC,2024-03-24,93,@,MIL,L 93-118,240,33,89,.371,23,46,.500,10,43,.233,17,22,.773,93,49,92,.533,38,58,.655,11,34,.324,9,14,.643,118
2338,BRK,2024-03-23,93,@,NYK,L 93-105,240,34,76,.447,22,42,.524,12,34,.353,13,15,.867,93,42,97,.433,27,57,.474,15,40,.375,6,12,.500,105
2339,LAC,2024-03-17,93,,ATL,L 93-110,240,28,74,.378,17,38,.447,11,36,.306,26,29,.897,93,41,84,.488,24,50,.480,17,34,.500,11,12,.917,110
2340,POR,2024-03-14,93,,NYK,L 93-105,240,34,84,.405,23,51,.451,11,33,.333,14,16,.875,93,38,87,.437,32,58,.552,6,29,.207,23,26,.885,105
2341,MEM,2024-03-10,93,@,OKC,L 93-124,240,32,78,.410,21,45,.467,11,33,.333,18,27,.667,93,49,93,.527,28,46,.609,21,47,.447,5,5,1.000,124
2342,CHO,2024-02-25,93,@,POR,W 93-80,240,37,75,.493,30,51,.588,7,24,.292,12,17,.706,93,33,95,.347,30,63,.476,3,32,.094,11,16,.688,80
2343,BRK,2024-02-22,93,@,TOR,L 93-121,240,33,80,.413,22,43,.512,11,37,.297,16,22,.727,93,41,84,.488,27,53,.509,14,31,.452,25,30,.833,121
2344,SAS,2024-02-14,93,@,DAL,L 93-116,240,36,100,.360,26,60,.433,10,40,.250,11,15,.733,93,49,92,.533,38,62,.613,11,30,.367,7,10,.700,116
2345,NOP,2024-02-10,93,@,POR,W 93-84,240,36,76,.474,26,49,.531,10,27,.370,11,16,.688,93,33,76,.434,27,55,.491,6,21,.286,12,17,.706,84
2346,SAC,2024-01-12,93,@,PHI,L 93-112,240,32,95,.337,24,57,.421,8,38,.211,21,26,.808,93,40,93,.430,25,58,.431,15,35,.429,17,18,.944,112
2347,POR,2024-01-12,93,@,MIN,L 93-116,240,30,77,.390,20,49,.408,10,28,.357,23,34,.676,93,44,80,.550,33,49,.673,11,31,.355,17,24,.708,116
2348,CHO,2024-01-01,93,@,DEN,L 93-111,240,36,86,.419,26,60,.433,10,26,.385,11,16,.688,93,41,83,.494,26,45,.578,15,38,.395,14,18,.778,111
2349,DEN,2023-12-29,93,,OKC,L 93-119,240,36,85,.424,26,48,.542,10,37,.270,11,15,.733,93,46,91,.505,34,56,.607,12,35,.343,15,16,.938,119
2350,HOU,2023-12-11,93,,SAS,W 93-82,240,32,93,.344,20,54,.370,12,39,.308,17,20,.850,93,31,87,.356,26,46,.565,5,41,.122,15,22,.682,82
2351,SAC,2023-11-20,93,@,NOP,L 93-129,240,33,87,.379,22,42,.524,11,45,.244,16,24,.667,93,50,92,.543,38,64,.594,12,28,.429,17,21,.810,129
2352,LAC,2023-11-08,93,@,BRK,L 93-100,240,36,91,.396,28,55,.509,8,36,.222,13,13,1.000,93,37,92,.402,22,51,.431,15,41,.366,11,13,.846,100
2353,POR,2024-04-11,92,,GSW,L 92-100,240,35,97,.361,27,63,.429,8,34,.235,14,17,.824,92,36,77,.468,24,42,.571,12,35,.343,16,20,.800,100
2354,MIA,2024-04-10,92,,DAL,L 92-111,240,33,81,.407,20,51,.392,13,30,.433,13,13,1.000,92,43,87,.494,28,43,.651,15,44,.341,10,13,.769,111
2355,PHO,2024-04-09,92,,LAC,L 92-105,240,30,89,.337,22,54,.407,8,35,.229,24,28,.857,92,41,87,.471,29,61,.475,12,26,.462,11,11,1.000,105
2356,NOP,2024-03-30,92,,BOS,L 92-104,240,34,86,.395,21,51,.412,13,35,.371,11,18,.611,92,39,82,.476,24,45,.533,15,37,.405,11,12,.917,104
2357,MIA,2024-03-26,92,,GSW,L 92-113,240,37,92,.402,29,59,.492,8,33,.242,10,13,.769,92,47,85,.553,34,47,.723,13,38,.342,6,10,.600,113
2358,CHO,2024-03-25,92,@,CLE,L 92-115,240,34,80,.425,25,52,.481,9,28,.321,15,18,.833,92,46,86,.535,29,45,.644,17,41,.415,6,10,.600,115
2359,POR,2024-03-25,92,@,HOU,L 92-110,240,36,87,.414,29,54,.537,7,33,.212,13,15,.867,92,37,93,.398,25,54,.463,12,39,.308,24,25,.960,110
2360,CHO,2024-03-19,92,@,ORL,L 92-112,240,38,79,.481,29,50,.580,9,29,.310,7,9,.778,92,44,81,.543,32,47,.681,12,34,.353,12,13,.923,112
2361,CHI,2024-03-11,92,,DAL,L 92-127,240,35,89,.393,28,55,.509,7,34,.206,15,22,.682,92,51,93,.548,38,52,.731,13,41,.317,12,15,.800,127
2362,MEM,2024-03-08,92,,ATL,L 92-99,240,30,74,.405,20,48,.417,10,26,.385,22,30,.733,92,37,87,.425,22,52,.423,15,35,.429,10,15,.667,99
2363,MEM,2024-03-01,92,,POR,L 92-122,240,35,79,.443,26,55,.473,9,24,.375,13,22,.591,92,48,92,.522,35,61,.574,13,31,.419,13,16,.813,122
2364,NYK,2024-02-27,92,,NOP,L 92-115,240,31,83,.373,17,37,.459,14,46,.304,16,23,.696,92,39,77,.506,21,43,.488,18,34,.529,19,23,.826,115
2365,ORL,2024-02-25,92,@,ATL,L 92-109,240,35,84,.417,21,46,.457,14,38,.368,8,18,.444,92,41,90,.456,29,61,.475,12,29,.414,15,17,.882,109
2366,CHO,2024-01-29,92,,NYK,L 92-113,240,37,81,.457,26,49,.531,11,32,.344,7,14,.500,92,44,84,.524,32,47,.681,12,37,.324,13,16,.813,113
2367,ORL,2024-01-09,92,,MIN,L 92-113,240,34,94,.362,21,52,.404,13,42,.310,11,18,.611,92,43,80,.538,31,50,.620,12,30,.400,15,19,.789,113
2368,PHI,2024-01-05,92,,NYK,L 92-128,240,33,81,.407,27,58,.466,6,23,.261,20,27,.741,92,43,89,.483,25,48,.521,18,41,.439,24,25,.960,128
2369,MEM,2023-12-31,92,,SAC,L 92-123,240,30,82,.366,18,42,.429,12,40,.300,20,28,.714,92,47,92,.511,31,59,.525,16,33,.485,13,17,.765,123
2370,PHI,2023-12-30,92,@,CHI,L 92-105,240,36,92,.391,27,54,.500,9,38,.237,11,15,.733,92,40,79,.506,33,54,.611,7,25,.280,18,30,.600,105
2371,ORL,2023-12-27,92,,PHI,L 92-112,240,31,79,.392,22,46,.478,9,33,.273,21,24,.875,92,45,96,.469,35,68,.515,10,28,.357,12,17,.706,112
2372,DET,2023-12-15,92,@,PHI,L 92-124,240,35,81,.432,31,60,.517,4,21,.190,18,23,.783,92,41,98,.418,27,61,.443,14,37,.378,28,31,.903,124
2373,BOS,2024-04-09,91,@,MIL,L 91-104,240,37,93,.398,20,41,.488,17,52,.327,0,0,,91,43,81,.531,26,45,.578,17,36,.472,1,2,.500,104
2374,DET,2024-03-27,91,@,MIN,L 91-106,240,31,81,.383,22,49,.449,9,32,.281,20,25,.800,91,42,82,.512,31,46,.674,11,36,.306,11,16,.688,106
2375,CHO,2024-03-23,91,@,ATL,L 91-132,240,35,84,.417,24,45,.533,11,39,.282,10,14,.714,91,50,90,.556,30,48,.625,20,42,.476,12,14,.857,132
2376,CLE,2024-03-22,91,@,MIN,L 91-104,240,34,81,.420,27,52,.519,7,29,.241,16,19,.842,91,41,85,.482,27,58,.466,14,27,.519,8,16,.500,104
2377,BRK,2024-03-19,91,,NOP,L 91-104,240,31,84,.369,19,44,.432,12,40,.300,17,22,.773,91,42,83,.506,32,49,.653,10,34,.294,10,13,.769,104
2378,MIA,2024-03-18,91,@,PHI,L 91-98,240,35,89,.393,23,56,.411,12,33,.364,9,14,.643,91,37,85,.435,24,49,.490,13,36,.361,11,12,.917,98
2379,SAC,2024-03-16,91,,NYK,L 91-98,240,30,85,.353,20,48,.417,10,37,.270,21,26,.808,91,37,86,.430,26,47,.553,11,39,.282,13,16,.813,98
2380,DET,2024-03-03,91,@,ORL,L 91-113,240,33,86,.384,25,50,.500,8,36,.222,17,20,.850,91,43,72,.597,36,49,.735,7,23,.304,20,25,.800,113
2381,POR,2024-02-15,91,,MIN,L 91-128,240,31,83,.373,23,54,.426,8,29,.276,21,30,.700,91,46,89,.517,35,59,.593,11,30,.367,25,27,.926,128
2382,MEM,2024-02-04,91,@,BOS,L 91-131,240,35,92,.380,24,54,.444,11,38,.289,10,12,.833,91,48,99,.485,29,48,.604,19,51,.373,16,18,.889,131
2383,CHI,2024-01-15,91,@,CLE,L 91-109,240,35,83,.422,26,51,.510,9,32,.281,12,16,.750,91,39,95,.411,19,38,.500,20,57,.351,11,11,1.000,109
2384,CHO,2024-01-05,91,@,CHI,L 91-104,240,36,89,.404,26,55,.473,10,34,.294,9,12,.750,91,40,74,.541,30,46,.652,10,28,.357,14,17,.824,104
2385,DET,2023-12-08,91,@,ORL,L 91-123,240,34,81,.420,28,51,.549,6,30,.200,17,24,.708,91,49,89,.551,39,63,.619,10,26,.385,15,19,.789,123
2386,UTA,2023-11-29,91,@,MEM,L 91-105,240,34,90,.378,18,51,.353,16,39,.410,7,12,.583,91,43,87,.494,30,48,.625,13,39,.333,6,8,.750,105
2387,CHO,2023-11-28,91,@,NYK,L 91-115,240,37,89,.416,24,58,.414,13,31,.419,4,7,.571,91,41,88,.466,26,50,.520,15,38,.395,18,20,.900,115
2388,MEM,2023-11-22,91,@,HOU,L 91-111,240,27,82,.329,20,50,.400,7,32,.219,30,35,.857,91,40,92,.435,26,49,.531,14,43,.326,17,20,.850,111
2389,POR,2023-11-19,91,,OKC,L 91-134,240,34,85,.400,25,51,.490,9,34,.265,14,21,.667,91,49,81,.605,27,45,.600,22,36,.611,14,14,1.000,134
2390,CLE,2023-10-31,91,,NYK,L 91-109,240,36,92,.391,26,54,.481,10,38,.263,9,12,.750,91,38,86,.442,25,52,.481,13,34,.382,20,25,.800,109
2391,TOR,2023-10-30,91,,POR,L 91-99,240,38,94,.404,34,65,.523,4,29,.138,11,15,.733,91,38,85,.447,27,50,.540,11,35,.314,12,15,.800,99
2392,DET,2024-04-05,90,@,MEM,L 90-108,240,32,79,.405,24,49,.490,8,30,.267,18,24,.750,90,42,90,.467,32,59,.542,10,31,.323,14,16,.875,108
2393,LAL,2024-03-29,90,@,IND,L 90-109,240,35,86,.407,30,56,.536,5,30,.167,15,18,.833,90,43,89,.483,33,58,.569,10,31,.323,13,14,.929,109
2394,MIL,2024-03-06,90,@,GSW,L 90-125,240,34,89,.382,23,50,.460,11,39,.282,11,15,.733,90,51,91,.560,32,52,.615,19,39,.487,4,7,.571,125
2395,HOU,2024-02-04,90,@,MIN,L 90-111,240,31,88,.352,21,58,.362,10,30,.333,18,27,.667,90,40,90,.444,29,60,.483,11,30,.367,20,27,.741,111
2396,WAS,2024-01-05,90,@,CLE,L 90-114,240,35,84,.417,26,54,.481,9,30,.300,11,15,.733,90,41,77,.532,25,44,.568,16,33,.485,16,23,.696,114
2397,DAL,2024-01-01,90,@,UTA,L 90-127,240,37,93,.398,26,53,.491,11,40,.275,5,10,.500,90,49,96,.510,37,52,.712,12,44,.273,17,18,.944,127
2398,UTA,2023-11-30,90,@,MIN,L 90-101,240,33,87,.379,22,53,.415,11,34,.324,13,14,.929,90,39,89,.438,26,54,.481,13,35,.371,10,13,.769,101
2399,MIA,2023-10-28,90,@,MIN,L 90-106,240,35,87,.402,23,49,.469,12,38,.316,8,14,.571,90,44,86,.512,32,52,.615,12,34,.353,6,8,.750,106
2400,DAL,2024-04-12,89,,DET,L 89-107,240,36,83,.434,28,54,.519,8,29,.276,9,12,.750,89,46,95,.484,38,64,.594,8,31,.258,7,9,.778,107
2401,SAS,2024-04-10,89,@,OKC,L 89-127,240,32,96,.333,23,56,.411,9,40,.225,16,20,.800,89,47,101,.465,31,63,.492,16,38,.421,17,21,.810,127
2402,POR,2024-04-03,89,@,CHO,W 89-86,240,37,93,.398,30,67,.448,7,26,.269,8,12,.667,89,32,78,.410,27,47,.574,5,31,.161,17,22,.773,86
2403,TOR,2024-03-20,89,,SAC,L 89-123,240,33,80,.413,23,49,.469,10,31,.323,13,18,.722,89,48,93,.516,36,53,.679,12,40,.300,15,18,.833,123
2404,CHO,2024-03-05,89,,ORL,L 89-101,240,33,72,.458,21,39,.538,12,33,.364,11,11,1.000,89,40,74,.541,27,39,.692,13,35,.371,8,15,.533,101
2405,LAC,2024-03-03,89,@,MIN,W 89-88,240,32,85,.376,22,51,.431,10,34,.294,15,17,.882,89,31,80,.388,22,47,.468,9,33,.273,17,18,.944,88
2406,CHO,2024-01-20,89,,PHI,L 89-97,240,35,85,.412,26,48,.542,9,37,.243,10,14,.714,89,36,85,.424,31,60,.517,5,25,.200,20,24,.833,97
2407,NOP,2023-12-07,89,@,LAL,L 89-133,240,34,95,.358,27,64,.422,7,31,.226,14,20,.700,89,47,86,.547,30,51,.588,17,35,.486,22,29,.759,133
2408,MEM,2023-11-24,89,,PHO,L 89-110,240,37,80,.463,28,47,.596,9,33,.273,6,10,.600,89,39,76,.513,28,45,.622,11,31,.355,21,28,.750,110
2409,SAC,2023-11-04,89,@,HOU,L 89-107,240,32,84,.381,21,43,.488,11,41,.268,14,19,.737,89,40,87,.460,27,51,.529,13,36,.361,14,20,.700,107
2410,DEN,2023-11-01,89,@,MIN,L 89-110,240,38,96,.396,32,63,.508,6,33,.182,7,10,.700,89,38,83,.458,30,62,.484,8,21,.381,26,27,.963,110
2411,NYK,2023-11-01,89,,CLE,L 89-95,240,32,92,.348,27,62,.435,5,30,.167,20,30,.667,89,32,74,.432,20,42,.476,12,32,.375,19,20,.950,95
2412,MIL,2024-04-14,88,@,ORL,L 88-113,240,30,75,.400,23,48,.479,7,27,.259,21,23,.913,88,42,85,.494,31,50,.620,11,35,.314,18,19,.947,113
2413,MEM,2024-03-30,88,@,ORL,L 88-118,240,31,86,.360,19,50,.380,12,36,.333,14,17,.824,88,38,78,.487,16,34,.471,22,44,.500,20,23,.870,118
2414,TOR,2024-03-25,88,,BRK,L 88-96,240,37,85,.435,32,58,.552,5,27,.185,9,12,.750,88,37,81,.457,28,42,.667,9,39,.231,13,18,.722,96
2415,MIA,2024-03-22,88,,NOP,L 88-111,240,31,86,.360,18,39,.462,13,47,.277,13,15,.867,88,42,82,.512,24,46,.522,18,36,.500,9,12,.750,111
2416,MIA,2024-03-13,88,,DEN,L 88-100,240,34,80,.425,29,59,.492,5,21,.238,15,18,.833,88,40,82,.488,29,49,.592,11,33,.333,9,13,.692,100
2417,MIN,2024-03-03,88,,LAC,L 88-89,240,31,80,.388,22,47,.468,9,33,.273,17,18,.944,88,32,85,.376,22,51,.431,10,34,.294,15,17,.882,89
2418,GSW,2024-03-03,88,@,BOS,L 88-140,240,36,92,.391,29,51,.569,7,41,.171,9,13,.692,88,53,96,.552,28,47,.596,25,49,.510,9,11,.818,140
2419,POR,2024-01-01,88,@,PHO,L 88-109,240,33,80,.413,25,50,.500,8,30,.267,14,19,.737,88,38,80,.475,27,51,.529,11,29,.379,22,33,.667,109
2420,DAL,2023-11-25,88,@,LAC,L 88-107,240,34,91,.374,25,53,.472,9,38,.237,11,14,.786,88,38,88,.432,30,59,.508,8,29,.276,23,31,.742,107
2421,MEM,2024-04-09,87,,SAS,L 87-102,240,36,104,.346,30,74,.405,6,30,.200,9,11,.818,87,42,87,.483,32,47,.681,10,40,.250,8,8,1.000,102
2422,MIN,2024-04-05,87,@,PHO,L 87-97,240,33,85,.388,23,56,.411,10,29,.345,11,14,.786,87,33,76,.434,24,50,.480,9,26,.346,22,29,.759,97
2423,WAS,2024-03-29,87,,DET,L 87-96,240,36,88,.409,27,55,.491,9,33,.273,6,8,.750,87,37,89,.416,31,65,.477,6,24,.250,16,20,.800,96
2424,MEM,2024-02-12,87,,NOP,L 87-96,240,34,81,.420,22,37,.595,12,44,.273,7,8,.875,87,32,78,.410,19,43,.442,13,35,.371,19,24,.792,96
2425,DAL,2024-01-31,87,@,MIN,L 87-121,240,31,76,.408,25,47,.532,6,29,.207,19,26,.731,87,45,80,.563,32,50,.640,13,30,.433,18,30,.600,121
2426,MIA,2024-01-21,87,@,ORL,L 87-105,240,30,80,.375,18,43,.419,12,37,.324,15,18,.833,87,37,78,.474,28,50,.560,9,28,.321,22,28,.786,105
2427,CHO,2024-01-14,87,@,MIA,L 87-104,240,33,95,.347,23,54,.426,10,41,.244,11,15,.733,87,40,81,.494,29,56,.518,11,25,.440,13,16,.813,104
2428,SAS,2023-11-14,87,@,OKC,L 87-123,240,36,93,.387,27,63,.429,9,30,.300,6,9,.667,87,46,89,.517,31,50,.620,15,39,.385,16,20,.800,123
2429,NYK,2023-10-28,87,@,NOP,L 87-96,240,33,90,.367,26,53,.491,7,37,.189,14,18,.778,87,40,87,.460,31,54,.574,9,33,.273,7,16,.438,96
2430,DAL,2024-04-14,86,@,OKC,L 86-135,240,32,97,.330,24,58,.414,8,39,.205,14,17,.824,86,54,97,.557,40,63,.635,14,34,.412,13,16,.813,135
2431,BRK,2024-04-14,86,@,PHI,L 86-107,240,32,83,.386,23,49,.469,9,34,.265,13,17,.765,86,41,96,.427,27,52,.519,14,44,.318,11,15,.733,107
2432,CHO,2024-04-03,86,,POR,L 86-89,240,32,78,.410,27,47,.574,5,31,.161,17,22,.773,86,37,93,.398,30,67,.448,7,26,.269,8,12,.667,89
2433,MEM,2024-02-26,86,,BRK,L 86-111,240,29,75,.387,22,49,.449,7,26,.269,21,26,.808,86,44,90,.489,29,48,.604,15,42,.357,8,14,.571,111
2434,BRK,2024-02-24,86,@,MIN,L 86-101,240,35,104,.337,29,69,.420,6,35,.171,10,11,.909,86,36,84,.429,24,46,.522,12,38,.316,17,23,.739,101
2435,BRK,2024-02-14,86,@,BOS,L 86-136,240,31,81,.383,21,50,.420,10,31,.323,14,15,.933,86,52,91,.571,30,46,.652,22,45,.489,10,12,.833,136
2436,DEN,2023-11-24,86,@,HOU,L 86-105,240,32,94,.340,25,64,.391,7,30,.233,15,21,.714,86,40,82,.488,28,53,.528,12,29,.414,13,15,.867,105
2437,HOU,2023-10-25,86,@,ORL,L 86-116,240,32,79,.405,20,45,.444,12,34,.353,10,16,.625,86,42,87,.483,33,53,.623,9,34,.265,23,26,.885,116
2438,TOR,2024-04-03,85,@,MIN,L 85-133,240,33,90,.367,26,60,.433,7,30,.233,12,14,.857,85,49,96,.510,29,53,.547,20,43,.465,15,22,.682,133
2439,CHO,2024-02-27,85,@,MIL,L 85-123,240,30,81,.370,19,41,.463,11,40,.275,14,17,.824,85,46,89,.517,30,49,.612,16,40,.400,15,18,.833,123
2440,BRK,2024-01-02,85,@,NOP,L 85-112,240,35,98,.357,24,55,.436,11,43,.256,4,8,.500,85,41,88,.466,25,49,.510,16,39,.410,14,18,.778,112
2441,CLE,2024-03-24,84,@,MIA,L 84-121,240,30,72,.417,21,43,.488,9,29,.310,15,20,.750,84,43,83,.518,28,45,.622,15,38,.395,20,23,.870,121
2442,CHO,2024-02-23,84,@,GSW,L 84-97,240,32,88,.364,21,49,.429,11,39,.282,9,11,.818,84,38,89,.427,25,47,.532,13,42,.310,8,10,.800,97
2443,POR,2024-02-10,84,,NOP,L 84-93,240,33,76,.434,27,55,.491,6,21,.286,12,17,.706,84,36,76,.474,26,49,.531,10,27,.370,11,16,.688,93
2444,CHO,2024-02-09,84,@,MIL,L 84-120,240,27,79,.342,20,50,.400,7,29,.241,23,29,.793,84,41,94,.436,23,42,.548,18,52,.346,20,24,.833,120
2445,DEN,2024-01-25,84,@,NYK,L 84-122,240,34,84,.405,29,58,.500,5,26,.192,11,13,.846,84,45,85,.529,30,47,.638,15,38,.395,17,20,.850,122
2446,POR,2024-01-09,84,@,NYK,L 84-112,240,33,86,.384,27,57,.474,6,29,.207,12,18,.667,84,37,89,.416,19,41,.463,18,48,.375,20,23,.870,112
2447,NOP,2024-01-26,83,,OKC,L 83-107,240,32,82,.390,23,46,.500,9,36,.250,10,14,.714,83,42,88,.477,32,55,.582,10,33,.303,13,14,.929,107
2448,SAS,2023-10-29,83,@,LAC,L 83-123,240,30,80,.375,19,47,.404,11,33,.333,12,16,.750,83,47,91,.516,31,49,.633,16,42,.381,13,21,.619,123
2449,POR,2024-04-14,82,@,SAC,L 82-121,240,31,98,.316,24,53,.453,7,45,.156,13,17,.765,82,43,87,.494,30,53,.566,13,34,.382,22,27,.815,121
2450,POR,2024-03-29,82,@,MIA,L 82-142,240,35,87,.402,30,57,.526,5,30,.167,7,11,.636,82,54,92,.587,33,53,.623,21,39,.538,13,18,.722,142
2451,CHO,2023-12-16,82,,PHI,L 82-135,240,33,91,.363,26,56,.464,7,35,.200,9,11,.818,82,53,88,.602,39,57,.684,14,31,.452,15,17,.882,135
2452,SAS,2023-12-11,82,@,HOU,L 82-93,240,31,87,.356,26,46,.565,5,41,.122,15,22,.682,82,32,93,.344,20,54,.370,12,39,.308,17,20,.850,93
2453,BRK,2024-02-27,81,@,ORL,L 81-108,240,31,79,.392,23,48,.479,8,31,.258,11,14,.786,81,39,74,.527,30,49,.612,9,25,.360,21,25,.840,108
2454,POR,2024-02-25,80,,CHO,L 80-93,240,33,95,.347,30,63,.476,3,32,.094,11,16,.688,80,37,75,.493,30,51,.588,7,24,.292,12,17,.706,93
2455,PHI,2024-03-12,79,@,NYK,L 79-106,240,30,80,.375,22,47,.468,8,33,.242,11,16,.688,79,40,79,.506,26,39,.667,14,40,.350,12,15,.800,106
2456,PHI,2024-03-10,79,@,NYK,W 79-73,240,31,80,.388,22,50,.440,9,30,.300,8,14,.571,79,26,80,.325,17,40,.425,9,40,.225,12,16,.750,73
2457,BRK,2024-04-07,77,,SAC,L 77-107,240,30,86,.349,23,56,.411,7,30,.233,10,13,.769,77,40,94,.426,25,46,.543,15,48,.313,12,16,.750,107
2458,POR,2024-01-11,77,@,OKC,L 77-139,240,28,101,.277,17,52,.327,11,49,.224,10,16,.625,77,53,93,.570,39,58,.672,14,35,.400,19,22,.864,139
2459,ORL,2024-03-08,74,@,NYK,L 74-98,240,27,79,.342,21,53,.396,6,26,.231,14,20,.700,74,38,79,.481,22,46,.478,16,33,.485,6,8,.750,98
2460,NYK,2024-03-10,73,,PHI,L 73-79,240,26,80,.325,17,40,.425,9,40,.225,12,16,.750,73,31,80,.388,22,50,.440,9,30,.300,8,14,.571,79