Rk,Team,Date,PTS,,Opp,Result,MP,FG,FGA,FG%,2P,2PA,2P%,3P,3PA,3P%,FT,FTA,FT%,PTS,FG,FGA,FG%,2P,2PA,2P%,3P,3PA,3P%,FT,FTA,FT%,PTS
1,CLE,2024-11-15,144,,CHI,W 144-126,240,51,93,0.548,30,50,0.6,21,43,0.488,21,24,0.875,144,45,88,0.511,25,46,0.543,20,42,0.476,16,20,0.8,126
2,DEN,2024-10-29,144,@,BRK,W 144-139 (OT),265,46,89,0.517,33,62,0.532,13,27,0.481,39,47,0.83,144,49,96,0.51,29,44,0.659,20,52,0.385,21,27,0.778,139
3,HOU,2024-11-17,143,@,CHI,W 143-107,240,55,105,0.524,45,71,0.634,10,34,0.294,23,32,0.719,143,36,107,0.336,22,51,0.431,14,56,0.25,21,22,0.955,107
4,GSW,2024-10-23,140,@,POR,W 140-104,240,48,93,0.516,28,45,0.622,20,48,0.417,24,30,0.8,140,36,92,0.391,28,58,0.483,8,34,0.235,24,30,0.8,104
5,SAS,2024-11-13,139,,WAS,W 139-130,240,48,92,0.522,30,48,0.625,18,44,0.409,25,32,0.781,139,49,95,0.516,31,51,0.608,18,44,0.409,14,16,0.875,130
6,BOS,2024-11-13,139,@,BRK,W 139-114,240,50,93,0.538,28,47,0.596,22,46,0.478,17,24,0.708,139,40,79,0.506,21,36,0.583,19,43,0.442,15,18,0.833,114
7,BRK,2024-10-29,139,,DEN,L 139-144 (OT),265,49,96,0.51,29,44,0.659,20,52,0.385,21,27,0.778,139,46,89,0.517,33,62,0.532,13,27,0.481,39,47,0.83,144
8,CHO,2024-10-30,138,,TOR,W 138-133,240,49,94,0.521,29,49,0.592,20,45,0.444,20,25,0.8,138,52,91,0.571,43,63,0.683,9,28,0.321,20,30,0.667,133
9,OKC,2024-11-01,137,@,POR,W 137-114,240,51,95,0.537,32,46,0.696,19,49,0.388,16,19,0.842,137,39,83,0.47,24,48,0.5,15,35,0.429,21,31,0.677,114
10,CLE,2024-11-08,136,,GSW,W 136-117,240,46,85,0.541,26,43,0.605,20,42,0.476,24,28,0.857,136,47,98,0.48,34,56,0.607,13,42,0.31,10,14,0.714,117
11,CLE,2024-10-23,136,@,TOR,W 136-106,240,51,87,0.586,37,57,0.649,14,30,0.467,20,26,0.769,136,36,86,0.419,24,55,0.436,12,31,0.387,22,29,0.759,106
12,DEN,2024-11-08,135,,MIA,W 135-122,240,50,81,0.617,32,46,0.696,18,35,0.514,17,19,0.895,135,46,94,0.489,26,51,0.51,20,43,0.465,10,13,0.769,122
13,MIN,2024-11-07,135,@,CHI,W 135-119,240,51,93,0.548,35,55,0.636,16,38,0.421,17,17,1,135,47,88,0.534,32,52,0.615,15,36,0.417,10,15,0.667,119
14,UTA,2024-11-04,135,@,CHI,W 135-126,240,48,89,0.539,32,53,0.604,16,36,0.444,23,30,0.767,135,45,95,0.474,31,58,0.534,14,37,0.378,22,25,0.88,126
15,IND,2024-10-30,135,,BOS,W 135-132 (OT),265,50,104,0.481,35,66,0.53,15,38,0.395,20,24,0.833,135,44,109,0.404,25,52,0.481,19,57,0.333,25,31,0.806,132
16,CLE,2024-10-26,135,@,WAS,W 135-116,240,47,88,0.534,29,49,0.592,18,39,0.462,23,34,0.676,135,37,96,0.385,22,53,0.415,15,43,0.349,27,32,0.844,116
17,OKC,2024-11-11,134,,LAC,W 134-128,240,47,91,0.516,29,45,0.644,18,46,0.391,22,23,0.957,134,44,80,0.55,24,43,0.558,20,37,0.541,20,29,0.69,128
18,MEM,2024-11-10,134,@,POR,W 134-89,240,47,85,0.553,31,42,0.738,16,43,0.372,24,28,0.857,134,34,100,0.34,30,58,0.517,4,42,0.095,17,21,0.81,89
19,IND,2024-11-04,134,@,DAL,W 134-127,240,54,95,0.568,41,63,0.651,13,32,0.406,13,20,0.65,134,46,89,0.517,31,53,0.585,15,36,0.417,20,25,0.8,127
20,CLE,2024-10-30,134,,LAL,W 134-110,240,56,97,0.577,39,56,0.696,17,41,0.415,5,8,0.625,134,38,77,0.494,32,49,0.653,6,28,0.214,28,33,0.848,110
21,TOR,2024-10-30,133,@,CHO,L 133-138,240,52,91,0.571,43,63,0.683,9,28,0.321,20,30,0.667,133,49,94,0.521,29,49,0.592,20,45,0.444,20,25,0.8,138
22,WAS,2024-10-30,133,,ATL,W 133-120,240,47,89,0.528,31,51,0.608,16,38,0.421,23,25,0.92,133,45,95,0.474,33,56,0.589,12,39,0.308,18,21,0.857,120
23,CHI,2024-10-25,133,@,MIL,W 133-122,240,46,96,0.479,25,49,0.51,21,47,0.447,20,23,0.87,133,46,93,0.495,33,53,0.623,13,40,0.325,17,25,0.68,122
24,IND,2024-11-10,132,,NYK,W 132-121,240,45,88,0.511,24,42,0.571,21,46,0.457,21,25,0.84,132,46,83,0.554,39,58,0.672,7,25,0.28,22,27,0.815,121
25,BOS,2024-10-30,132,@,IND,L 132-135 (OT),265,44,109,0.404,25,52,0.481,19,57,0.333,25,31,0.806,132,50,104,0.481,35,66,0.53,15,38,0.395,20,24,0.833,135
26,BOS,2024-10-22,132,,NYK,W 132-109,240,48,95,0.505,19,34,0.559,29,61,0.475,7,8,0.875,132,43,78,0.551,32,48,0.667,11,30,0.367,12,16,0.75,109
27,MEM,2024-11-06,131,,LAL,W 131-114,240,48,93,0.516,31,59,0.525,17,34,0.5,18,23,0.783,131,41,93,0.441,26,45,0.578,15,48,0.313,17,21,0.81,114
28,CLE,2024-11-06,131,@,NOP,W 131-122,240,52,96,0.542,35,61,0.574,17,35,0.486,10,13,0.769,131,42,88,0.477,29,61,0.475,13,27,0.481,25,28,0.893,122
29,TOR,2024-11-02,131,,SAC,W 131-128 (OT),265,46,95,0.484,29,58,0.5,17,37,0.459,22,31,0.71,131,46,100,0.46,36,60,0.6,10,40,0.25,26,32,0.813,128
30,LAL,2024-11-01,131,@,TOR,W 131-125,240,42,88,0.477,31,56,0.554,11,32,0.344,36,41,0.878,131,52,107,0.486,42,72,0.583,10,35,0.286,11,13,0.846,125
31,LAL,2024-10-26,131,,SAC,W 131-127,240,48,92,0.522,34,58,0.586,14,34,0.412,21,24,0.875,131,45,88,0.511,30,44,0.682,15,44,0.341,22,25,0.88,127
32,MIN,2024-11-15,130,@,SAC,W 130-126 (OT),265,48,101,0.475,28,52,0.538,20,49,0.408,14,16,0.875,130,48,96,0.5,36,59,0.61,12,37,0.324,18,20,0.9,126
33,WAS,2024-11-13,130,@,SAS,L 130-139,240,49,95,0.516,31,51,0.608,18,44,0.409,14,16,0.875,130,48,92,0.522,30,48,0.625,18,44,0.409,25,32,0.781,139
34,ATL,2024-11-15,129,,WAS,W 129-117,240,46,98,0.469,34,61,0.557,12,37,0.324,25,30,0.833,129,43,106,0.406,28,63,0.444,15,43,0.349,16,21,0.762,117
35,DEN,2024-11-02,129,,UTA,W 129-103,240,48,99,0.485,32,67,0.478,16,32,0.5,17,23,0.739,129,32,77,0.416,19,35,0.543,13,42,0.31,26,31,0.839,103
36,CLE,2024-11-17,128,,CHO,W 128-114,240,44,77,0.571,31,47,0.66,13,30,0.433,27,28,0.964,128,42,103,0.408,22,51,0.431,20,52,0.385,10,12,0.833,114
37,LAL,2024-11-13,128,,MEM,W 128-123,240,43,85,0.506,23,44,0.523,20,41,0.488,22,32,0.688,128,42,89,0.472,30,56,0.536,12,33,0.364,27,33,0.818,123
38,LAC,2024-11-11,128,@,OKC,L 128-134,240,44,80,0.55,24,43,0.558,20,37,0.541,20,29,0.69,128,47,91,0.516,29,45,0.644,18,46,0.391,22,23,0.957,134
39,MEM,2024-11-08,128,,WAS,W 128-104,240,46,97,0.474,32,54,0.593,14,43,0.326,22,25,0.88,128,38,93,0.409,29,58,0.5,9,35,0.257,19,23,0.826,104
40,SAC,2024-11-02,128,@,TOR,L 128-131 (OT),265,46,100,0.46,36,60,0.6,10,40,0.25,26,32,0.813,128,46,95,0.484,29,58,0.5,17,37,0.459,22,31,0.71,131
41,NYK,2024-11-01,128,@,DET,W 128-98,240,52,101,0.515,34,63,0.54,18,38,0.474,6,10,0.6,128,41,81,0.506,30,47,0.638,11,34,0.324,5,7,0.714,98
42,OKC,2024-10-27,128,,ATL,W 128-104,240,44,89,0.494,28,49,0.571,16,40,0.4,24,32,0.75,128,36,91,0.396,26,60,0.433,10,31,0.323,22,29,0.759,104
43,HOU,2024-10-25,128,,MEM,W 128-108,240,43,98,0.439,26,55,0.473,17,43,0.395,25,36,0.694,128,38,91,0.418,28,63,0.444,10,28,0.357,22,36,0.611,108
44,MIL,2024-11-13,127,,DET,W 127-120 (OT),265,45,95,0.474,30,60,0.5,15,35,0.429,22,25,0.88,127,46,100,0.46,28,62,0.452,18,38,0.474,10,13,0.769,120
45,SAC,2024-11-13,127,,PHO,W 127-104,240,50,78,0.641,35,50,0.7,15,28,0.536,12,17,0.706,127,36,97,0.371,23,54,0.426,13,43,0.302,19,26,0.731,104
46,GSW,2024-11-10,127,@,OKC,W 127-116,240,45,89,0.506,24,46,0.522,21,43,0.488,16,23,0.696,127,42,94,0.447,31,61,0.508,11,33,0.333,21,26,0.808,116
47,SAC,2024-11-10,127,@,PHO,W 127-118 (OT),265,50,102,0.49,39,65,0.6,11,37,0.297,16,19,0.842,127,44,105,0.419,26,48,0.542,18,57,0.316,12,15,0.8,118
48,MIN,2024-11-08,127,,POR,W 127-102,240,47,97,0.485,25,47,0.532,22,50,0.44,11,14,0.786,127,39,91,0.429,33,66,0.5,6,25,0.24,18,24,0.75,102
49,HOU,2024-11-06,127,,SAS,W 127-100,240,54,96,0.563,44,69,0.638,10,27,0.37,9,15,0.6,127,37,83,0.446,23,47,0.489,14,36,0.389,12,16,0.75,100
50,DAL,2024-11-04,127,,IND,L 127-134,240,46,89,0.517,31,53,0.585,15,36,0.417,20,25,0.8,127,54,95,0.568,41,63,0.651,13,32,0.406,13,20,0.65,134
51,GSW,2024-11-02,127,@,HOU,W 127-121 (OT),265,40,78,0.513,25,46,0.543,15,32,0.469,32,50,0.64,127,44,107,0.411,29,62,0.468,15,45,0.333,18,24,0.75,121
52,DEN,2024-10-28,127,@,TOR,W 127-125 (OT),265,47,96,0.49,38,76,0.5,9,20,0.45,24,30,0.8,127,49,109,0.45,39,74,0.527,10,35,0.286,17,21,0.81,125
53,SAC,2024-10-26,127,@,LAL,L 127-131,240,45,88,0.511,30,44,0.682,15,44,0.341,22,25,0.88,127,48,92,0.522,34,58,0.586,14,34,0.412,21,24,0.875,131
54,GSW,2024-10-25,127,@,UTA,W 127-86,240,51,106,0.481,31,56,0.554,20,50,0.4,5,6,0.833,127,29,92,0.315,20,50,0.4,9,42,0.214,19,26,0.731,86
55,BOS,2024-11-16,126,,TOR,W 126-123 (OT),265,44,99,0.444,23,38,0.605,21,61,0.344,17,19,0.895,126,50,98,0.51,41,75,0.547,9,23,0.391,14,21,0.667,123
56,SAC,2024-11-15,126,,MIN,L 126-130 (OT),265,48,96,0.5,36,59,0.61,12,37,0.324,18,20,0.9,126,48,101,0.475,28,52,0.538,20,49,0.408,14,16,0.875,130
57,CHI,2024-11-15,126,@,CLE,L 126-144,240,45,88,0.511,25,46,0.543,20,42,0.476,16,20,0.8,126,51,93,0.548,30,50,0.6,21,43,0.488,21,24,0.875,144
58,OKC,2024-11-08,126,,HOU,W 126-107,240,46,90,0.511,32,53,0.604,14,37,0.378,20,23,0.87,126,39,90,0.433,28,60,0.467,11,30,0.367,18,26,0.692,107
59,CHI,2024-11-04,126,,UTA,L 126-135,240,45,95,0.474,31,58,0.534,14,37,0.378,22,25,0.88,126,48,89,0.539,32,53,0.604,16,36,0.444,23,30,0.767,135
60,ATL,2024-11-03,126,@,NOP,W 126-111,240,50,88,0.568,35,52,0.673,15,36,0.417,11,12,0.917,126,39,90,0.433,23,52,0.442,16,38,0.421,17,20,0.85,111
61,CHI,2024-10-28,126,@,MEM,W 126-123,240,45,100,0.45,20,47,0.426,25,53,0.472,11,17,0.647,126,51,111,0.459,37,68,0.544,14,43,0.326,7,13,0.538,123
62,MEM,2024-10-23,126,@,UTA,W 126-124,240,43,91,0.473,26,46,0.565,17,45,0.378,23,32,0.719,126,40,85,0.471,30,59,0.508,10,26,0.385,34,45,0.756,124
63,HOU,2024-11-15,125,,LAC,W 125-104,240,46,95,0.484,27,51,0.529,19,44,0.432,14,18,0.778,125,34,90,0.378,24,50,0.48,10,40,0.25,26,33,0.788,104
64,CHI,2024-11-09,125,@,ATL,W 125-113,240,46,92,0.5,33,53,0.623,13,39,0.333,20,23,0.87,125,41,89,0.461,32,60,0.533,9,29,0.31,22,30,0.733,113
65,GSW,2024-11-04,125,@,WAS,W 125-112,240,44,97,0.454,32,60,0.533,12,37,0.324,25,34,0.735,125,42,96,0.438,32,53,0.604,10,43,0.233,18,21,0.857,112
66,NOP,2024-11-01,125,,IND,W 125-118,240,49,101,0.485,37,70,0.529,12,31,0.387,15,19,0.789,125,46,89,0.517,30,51,0.588,16,38,0.421,10,13,0.769,118
67,TOR,2024-11-01,125,,LAL,L 125-131,240,52,107,0.486,42,72,0.583,10,35,0.286,11,13,0.846,125,42,88,0.477,31,56,0.554,11,32,0.344,36,41,0.878,131
68,PHO,2024-10-31,125,@,LAC,W 125-119,240,42,82,0.512,24,43,0.558,18,39,0.462,23,28,0.821,125,45,93,0.484,33,58,0.569,12,35,0.343,17,21,0.81,119
69,TOR,2024-10-28,125,,DEN,L 125-127 (OT),265,49,109,0.45,39,74,0.527,10,35,0.286,17,21,0.81,125,47,96,0.49,38,76,0.5,9,20,0.45,24,30,0.8,127
70,POR,2024-10-27,125,,NOP,W 125-103,240,43,93,0.462,29,58,0.5,14,35,0.4,25,32,0.781,125,38,88,0.432,30,59,0.508,8,29,0.276,19,24,0.792,103
71,ATL,2024-10-25,125,,CHO,W 125-120,240,39,81,0.481,25,43,0.581,14,38,0.368,33,38,0.868,125,37,96,0.385,16,45,0.356,21,51,0.412,25,31,0.806,120
72,DET,2024-11-17,124,@,WAS,W 124-104,240,46,97,0.474,29,59,0.492,17,38,0.447,15,19,0.789,124,39,83,0.47,27,56,0.482,12,27,0.444,14,20,0.7,104
73,MIA,2024-11-15,124,@,IND,W 124-111,240,45,87,0.517,30,45,0.667,15,42,0.357,19,23,0.826,124,44,86,0.512,30,51,0.588,14,35,0.4,9,11,0.818,111
74,NYK,2024-11-15,124,,BRK,W 124-122,240,44,83,0.53,31,45,0.689,13,38,0.342,23,28,0.821,124,39,89,0.438,20,43,0.465,19,46,0.413,25,28,0.893,122
75,CHI,2024-11-13,124,@,NYK,W 124-123,240,44,82,0.537,30,46,0.652,14,36,0.389,22,27,0.815,124,48,94,0.511,33,57,0.579,15,37,0.405,12,18,0.667,123
76,DEN,2024-11-06,124,,OKC,W 124-122,240,42,89,0.472,26,51,0.51,16,38,0.421,24,33,0.727,124,44,100,0.44,28,60,0.467,16,40,0.4,18,23,0.783,122
77,MEM,2024-11-02,124,@,PHI,W 124-107,240,48,87,0.552,36,60,0.6,12,27,0.444,16,21,0.762,124,36,89,0.404,17,43,0.395,19,46,0.413,16,20,0.8,107
78,BOS,2024-11-01,124,@,CHO,W 124-109,240,41,86,0.477,28,44,0.636,13,42,0.31,29,35,0.829,124,42,91,0.462,23,43,0.535,19,48,0.396,6,12,0.5,109
79,GSW,2024-10-29,124,,NOP,W 124-106,240,46,97,0.474,25,51,0.49,21,46,0.457,11,13,0.846,124,40,74,0.541,31,52,0.596,9,22,0.409,17,24,0.708,106
80,BOS,2024-10-26,124,@,DET,W 124-118,240,38,90,0.422,16,42,0.381,22,48,0.458,26,30,0.867,124,43,88,0.489,29,49,0.592,14,39,0.359,18,22,0.818,118
81,MEM,2024-10-26,124,,ORL,W 124-111,240,46,86,0.535,33,52,0.635,13,34,0.382,19,24,0.792,124,37,87,0.425,20,39,0.513,17,48,0.354,20,28,0.714,111
82,UTA,2024-10-23,124,,MEM,L 124-126,240,40,85,0.471,30,59,0.508,10,26,0.385,34,45,0.756,124,43,91,0.473,26,46,0.565,17,45,0.378,23,32,0.719,126
83,MIL,2024-10-23,124,@,PHI,W 124-109,240,43,80,0.538,27,43,0.628,16,37,0.432,22,31,0.71,124,41,98,0.418,33,67,0.493,8,31,0.258,19,27,0.704,109
84,TOR,2024-11-16,123,@,BOS,L 123-126 (OT),265,50,98,0.51,41,75,0.547,9,23,0.391,14,21,0.667,123,44,99,0.444,23,38,0.605,21,61,0.344,17,19,0.895,126
85,GSW,2024-11-15,123,,MEM,W 123-118,240,43,98,0.439,24,52,0.462,19,46,0.413,18,25,0.72,123,42,103,0.408,35,61,0.574,7,42,0.167,27,33,0.818,118
86,MEM,2024-11-13,123,@,LAL,L 123-128,240,42,89,0.472,30,56,0.536,12,33,0.364,27,33,0.818,123,43,85,0.506,23,44,0.523,20,41,0.488,22,32,0.688,128
87,NYK,2024-11-13,123,,CHI,L 123-124,240,48,94,0.511,33,57,0.579,15,37,0.405,12,18,0.667,123,44,82,0.537,30,46,0.652,14,36,0.389,22,27,0.815,124
88,DET,2024-11-12,123,,MIA,W 123-121 (OT),265,43,92,0.467,30,56,0.536,13,36,0.361,24,28,0.857,123,47,101,0.465,30,56,0.536,17,45,0.378,10,13,0.769,121
89,LAL,2024-11-10,123,,TOR,W 123-103,240,44,86,0.512,32,49,0.653,12,37,0.324,23,28,0.821,123,37,82,0.451,27,53,0.509,10,29,0.345,19,22,0.864,103
90,MIL,2024-11-07,123,,UTA,W 123-100,240,43,84,0.512,28,49,0.571,15,35,0.429,22,30,0.733,123,33,77,0.429,16,36,0.444,17,41,0.415,17,18,0.944,100
91,BOS,2024-11-04,123,@,ATL,W 123-93,240,48,99,0.485,30,44,0.682,18,55,0.327,9,13,0.692,123,37,89,0.416,31,58,0.534,6,31,0.194,13,16,0.813,93
92,SAC,2024-11-01,123,@,ATL,W 123-115,240,43,89,0.483,32,56,0.571,11,33,0.333,26,30,0.867,123,41,92,0.446,22,42,0.524,19,50,0.38,14,18,0.778,115
93,MEM,2024-10-28,123,,CHI,L 123-126,240,51,111,0.459,37,68,0.544,14,43,0.326,7,13,0.538,123,45,100,0.45,20,47,0.426,25,53,0.472,11,17,0.647,126
94,LAL,2024-10-25,123,,PHO,W 123-116,240,40,75,0.533,26,48,0.542,14,27,0.519,29,39,0.744,123,42,82,0.512,25,45,0.556,17,37,0.459,15,17,0.882,116
95,NYK,2024-10-25,123,,IND,W 123-98,240,44,84,0.524,32,57,0.561,12,27,0.444,23,29,0.793,123,41,83,0.494,38,53,0.717,3,30,0.1,13,20,0.65,98
96,NOP,2024-10-23,123,,CHI,W 123-111,240,45,97,0.464,31,60,0.517,14,37,0.378,19,21,0.905,123,42,86,0.488,32,52,0.615,10,34,0.294,17,25,0.68,111
97,BRK,2024-11-15,122,@,NYK,L 122-124,240,39,89,0.438,20,43,0.465,19,46,0.413,25,28,0.893,122,44,83,0.53,31,45,0.689,13,38,0.342,23,28,0.821,124
98,POR,2024-11-12,122,,MIN,W 122-108,240,43,84,0.512,25,52,0.481,18,32,0.563,18,20,0.9,122,37,73,0.507,24,38,0.632,13,35,0.371,21,23,0.913,108
99,DEN,2024-11-10,122,,DAL,W 122-120,240,45,89,0.506,31,60,0.517,14,29,0.483,18,26,0.692,122,48,90,0.533,38,57,0.667,10,33,0.303,14,19,0.737,120
100,MIA,2024-11-08,122,@,DEN,L 122-135,240,46,94,0.489,26,51,0.51,20,43,0.465,10,13,0.769,122,50,81,0.617,32,46,0.696,18,35,0.514,17,19,0.895,135
101,DET,2024-11-08,122,,ATL,W 122-121,240,44,86,0.512,31,53,0.585,13,33,0.394,21,31,0.677,122,44,97,0.454,29,61,0.475,15,36,0.417,18,23,0.783,121
102,NOP,2024-11-06,122,,CLE,L 122-131,240,42,88,0.477,29,61,0.475,13,27,0.481,25,28,0.893,122,52,96,0.542,35,61,0.574,17,35,0.486,10,13,0.769,131
103,SAC,2024-11-06,122,,TOR,W 122-107,240,42,90,0.467,32,55,0.582,10,35,0.286,28,32,0.875,122,43,88,0.489,33,54,0.611,10,34,0.294,11,15,0.733,107
104,OKC,2024-11-06,122,@,DEN,L 122-124,240,44,100,0.44,28,60,0.467,16,40,0.4,18,23,0.783,122,42,89,0.472,26,51,0.51,16,38,0.421,24,33,0.727,124
105,MEM,2024-10-31,122,,MIL,W 122-99,240,43,82,0.524,35,54,0.648,8,28,0.286,28,31,0.903,122,41,96,0.427,32,54,0.593,9,42,0.214,8,19,0.421,99
106,MIL,2024-10-25,122,,CHI,L 122-133,240,46,93,0.495,33,53,0.623,13,40,0.325,17,25,0.68,122,46,96,0.479,25,49,0.51,21,47,0.447,20,23,0.87,133
107,BOS,2024-10-24,122,@,WAS,W 122-102,240,42,90,0.467,25,45,0.556,17,45,0.378,21,27,0.778,122,41,95,0.432,34,59,0.576,7,36,0.194,13,18,0.722,102
108,DAL,2024-11-17,121,@,OKC,W 121-119,240,40,84,0.476,29,57,0.509,11,27,0.407,30,36,0.833,121,43,87,0.494,29,45,0.644,14,42,0.333,19,25,0.76,119
109,SAC,2024-11-16,121,,UTA,W 121-117,240,42,83,0.506,23,42,0.548,19,41,0.463,18,25,0.72,121,37,75,0.493,25,49,0.51,12,26,0.462,31,42,0.738,117
110,MIA,2024-11-12,121,@,DET,L 121-123 (OT),265,47,101,0.465,30,56,0.536,17,45,0.378,10,13,0.769,121,43,92,0.467,30,56,0.536,13,36,0.361,24,28,0.857,123
111,ORL,2024-11-10,121,,WAS,W 121-94,240,41,91,0.451,24,43,0.558,17,48,0.354,22,25,0.88,121,33,72,0.458,23,39,0.59,10,33,0.303,18,25,0.72,94
112,NYK,2024-11-10,121,@,IND,L 121-132,240,46,83,0.554,39,58,0.672,7,25,0.28,22,27,0.815,121,45,88,0.511,24,42,0.571,21,46,0.457,21,25,0.84,132
113,ATL,2024-11-08,121,@,DET,L 121-122,240,44,97,0.454,29,61,0.475,15,36,0.417,18,23,0.783,121,44,86,0.512,31,53,0.585,13,33,0.394,21,31,0.677,122
114,ATL,2024-11-06,121,,NYK,W 121-116,240,45,100,0.45,30,62,0.484,15,38,0.395,16,22,0.727,121,41,84,0.488,19,37,0.514,22,47,0.468,12,15,0.8,116
115,DEN,2024-11-04,121,,TOR,W 121-119,240,41,83,0.494,31,52,0.596,10,31,0.323,29,38,0.763,121,47,103,0.456,34,64,0.531,13,39,0.333,12,18,0.667,119
116,HOU,2024-11-02,121,,GSW,L 121-127 (OT),265,44,107,0.411,29,62,0.468,15,45,0.333,18,24,0.75,121,40,78,0.513,25,46,0.543,15,32,0.469,32,50,0.64,127
117,WAS,2024-10-28,121,@,ATL,W 121-119,240,41,91,0.451,20,47,0.426,21,44,0.477,18,22,0.818,121,39,81,0.481,24,41,0.585,15,40,0.375,26,36,0.722,119
118,MIN,2024-11-17,120,,PHO,W 120-117,240,42,80,0.525,25,41,0.61,17,39,0.436,19,26,0.731,120,46,85,0.541,32,54,0.593,14,31,0.452,11,15,0.733,117
119,LAL,2024-11-15,120,@,SAS,W 120-115,240,44,88,0.5,30,57,0.526,14,31,0.452,18,23,0.783,120,43,88,0.489,26,43,0.605,17,45,0.378,12,16,0.75,115
120,DET,2024-11-13,120,@,MIL,L 120-127 (OT),265,46,100,0.46,28,62,0.452,18,38,0.474,10,13,0.769,120,45,95,0.474,30,60,0.5,15,35,0.429,22,25,0.88,127
121,PHO,2024-11-12,120,@,UTA,W 120-112,240,43,86,0.5,25,47,0.532,18,39,0.462,16,22,0.727,120,45,92,0.489,30,54,0.556,15,38,0.395,7,9,0.778,112
122,GSW,2024-11-12,120,,DAL,W 120-117,240,45,94,0.479,31,53,0.585,14,41,0.341,16,27,0.593,120,44,84,0.524,33,50,0.66,11,34,0.324,18,24,0.75,117
123,DAL,2024-11-10,120,@,DEN,L 120-122,240,48,90,0.533,38,57,0.667,10,33,0.303,14,19,0.737,120,45,89,0.506,31,60,0.517,14,29,0.483,18,26,0.692,122
124,BRK,2024-11-01,120,,CHI,W 120-112,240,49,94,0.521,38,58,0.655,11,36,0.306,11,13,0.846,120,38,88,0.432,21,44,0.477,17,44,0.386,19,24,0.792,112
125,CLE,2024-11-01,120,,ORL,W 120-109,240,44,87,0.506,29,49,0.592,15,38,0.395,17,20,0.85,120,41,90,0.456,30,57,0.526,11,33,0.333,16,24,0.667,109
126,ATL,2024-10-30,120,@,WAS,L 120-133,240,45,95,0.474,33,56,0.589,12,39,0.308,18,21,0.857,120,47,89,0.528,31,51,0.608,16,38,0.421,23,25,0.92,133
127,DAL,2024-10-29,120,@,MIN,W 120-114,240,45,93,0.484,29,54,0.537,16,39,0.41,14,18,0.778,120,39,77,0.506,20,38,0.526,19,39,0.487,17,26,0.654,114
128,CHO,2024-10-25,120,@,ATL,L 120-125,240,37,96,0.385,16,45,0.356,21,51,0.412,25,31,0.806,120,39,81,0.481,25,43,0.581,14,38,0.368,33,38,0.868,125
129,DAL,2024-10-24,120,,SAS,W 120-109,240,42,102,0.412,23,58,0.397,19,44,0.432,17,23,0.739,120,39,86,0.453,27,50,0.54,12,36,0.333,19,24,0.792,109
130,ATL,2024-10-23,120,,BRK,W 120-116,240,39,80,0.488,30,52,0.577,9,28,0.321,33,46,0.717,120,40,91,0.44,23,48,0.479,17,43,0.395,19,25,0.76,116
131,IND,2024-11-17,119,,MIA,W 119-110,240,44,85,0.518,31,56,0.554,13,29,0.448,18,20,0.9,119,36,90,0.4,17,47,0.362,19,43,0.442,19,20,0.95,110
132,OKC,2024-11-17,119,,DAL,L 119-121,240,43,87,0.494,29,45,0.644,14,42,0.333,19,25,0.76,119,40,84,0.476,29,57,0.509,11,27,0.407,30,36,0.833,121
133,CLE,2024-11-11,119,@,CHI,W 119-113,240,43,97,0.443,28,52,0.538,15,45,0.333,18,24,0.75,119,43,87,0.494,29,49,0.592,14,38,0.368,13,16,0.813,113
134,CHI,2024-11-07,119,,MIN,L 119-135,240,47,88,0.534,32,52,0.615,15,36,0.417,10,15,0.667,119,51,93,0.548,35,55,0.636,16,38,0.421,17,17,1,135
135,DAL,2024-11-06,119,,CHI,W 119-99,240,45,93,0.484,33,55,0.6,12,38,0.316,17,21,0.81,119,36,86,0.419,24,44,0.545,12,42,0.286,15,23,0.652,99
136,TOR,2024-11-04,119,@,DEN,L 119-121,240,47,103,0.456,34,64,0.531,13,39,0.333,12,18,0.667,119,41,83,0.494,31,52,0.596,10,31,0.323,29,38,0.763,121
137,MIN,2024-11-01,119,,DEN,W 119-116,240,43,83,0.518,25,41,0.61,18,42,0.429,15,18,0.833,119,41,92,0.446,30,60,0.5,11,32,0.344,23,29,0.793,116
138,LAC,2024-10-31,119,,PHO,L 119-125,240,45,93,0.484,33,58,0.569,12,35,0.343,17,21,0.81,119,42,82,0.512,24,43,0.558,18,39,0.462,23,28,0.821,125
139,BRK,2024-10-30,119,@,MEM,W 119-106,240,41,80,0.513,26,39,0.667,15,41,0.366,22,25,0.88,119,38,81,0.469,30,54,0.556,8,27,0.296,22,29,0.759,106
140,ORL,2024-10-28,119,,IND,W 119-115,240,39,83,0.47,26,42,0.619,13,41,0.317,28,38,0.737,119,41,88,0.466,28,59,0.475,13,29,0.448,20,30,0.667,115
141,BOS,2024-10-28,119,,MIL,W 119-108,240,43,87,0.494,25,40,0.625,18,47,0.383,15,19,0.789,119,37,82,0.451,29,51,0.569,8,31,0.258,26,31,0.839,108
142,ATL,2024-10-28,119,,WAS,L 119-121,240,39,81,0.481,24,41,0.585,15,40,0.375,26,36,0.722,119,41,91,0.451,20,47,0.426,21,44,0.477,18,22,0.818,121
143,MEM,2024-11-15,118,@,GSW,L 118-123,240,42,103,0.408,35,61,0.574,7,42,0.167,27,33,0.818,118,43,98,0.439,24,52,0.462,19,46,0.413,18,25,0.72,123
144,PHO,2024-11-10,118,,SAC,L 118-127 (OT),265,44,105,0.419,26,48,0.542,18,57,0.316,12,15,0.8,118,50,102,0.49,39,65,0.6,11,37,0.297,16,19,0.842,127
145,SAS,2024-11-07,118,,POR,W 118-105,240,44,82,0.537,28,43,0.651,16,39,0.41,14,18,0.778,118,41,86,0.477,32,54,0.593,9,32,0.281,14,22,0.636,105
146,GSW,2024-11-06,118,@,BOS,W 118-112,240,42,91,0.462,28,57,0.491,14,34,0.412,20,24,0.833,118,38,90,0.422,19,36,0.528,19,54,0.352,17,21,0.81,112
147,IND,2024-11-06,118,,ORL,W 118-111,240,41,76,0.539,29,50,0.58,12,26,0.462,24,26,0.923,118,42,82,0.512,35,57,0.614,7,25,0.28,20,26,0.769,111
148,POR,2024-11-04,118,@,NOP,W 118-100,240,46,84,0.548,36,55,0.655,10,29,0.345,16,24,0.667,118,38,84,0.452,28,49,0.571,10,35,0.286,14,16,0.875,100
149,PHO,2024-11-04,118,,PHI,W 118-116,240,42,82,0.512,31,50,0.62,11,32,0.344,23,26,0.885,118,40,87,0.46,20,36,0.556,20,51,0.392,16,18,0.889,116
150,MIA,2024-11-02,118,@,WAS,W 118-98,240,43,102,0.422,28,65,0.431,15,37,0.405,17,24,0.708,118,38,91,0.418,31,56,0.554,7,35,0.2,15,21,0.714,98
151,IND,2024-11-01,118,@,NOP,L 118-125,240,46,89,0.517,30,51,0.588,16,38,0.421,10,13,0.769,118,49,101,0.485,37,70,0.529,12,31,0.387,15,19,0.789,125
152,PHI,2024-10-27,118,@,IND,W 118-114 (OT),265,42,98,0.429,31,56,0.554,11,42,0.262,23,31,0.742,118,39,84,0.464,26,52,0.5,13,32,0.406,23,34,0.676,114
153,DET,2024-10-26,118,,BOS,L 118-124,240,43,88,0.489,29,49,0.592,14,39,0.359,18,22,0.818,118,38,90,0.422,16,42,0.381,22,48,0.458,26,30,0.867,124
154,PHO,2024-11-17,117,@,MIN,L 117-120,240,46,85,0.541,32,54,0.593,14,31,0.452,11,15,0.733,117,42,80,0.525,25,41,0.61,17,39,0.436,19,26,0.731,120
155,UTA,2024-11-16,117,@,SAC,L 117-121,240,37,75,0.493,25,49,0.51,12,26,0.462,31,42,0.738,117,42,83,0.506,23,42,0.548,19,41,0.463,18,25,0.72,121
156,WAS,2024-11-15,117,@,ATL,L 117-129,240,43,106,0.406,28,63,0.444,15,43,0.349,16,21,0.762,117,46,98,0.469,34,61,0.557,12,37,0.324,25,30,0.833,129
157,DAL,2024-11-12,117,@,GSW,L 117-120,240,44,84,0.524,33,50,0.66,11,34,0.324,18,24,0.75,117,45,94,0.479,31,53,0.585,14,41,0.341,16,27,0.593,120
158,ATL,2024-11-12,117,@,BOS,W 117-116,240,50,99,0.505,40,67,0.597,10,32,0.313,7,13,0.538,117,38,75,0.507,20,30,0.667,18,45,0.4,22,27,0.815,116
159,GSW,2024-11-08,117,@,CLE,L 117-136,240,47,98,0.48,34,56,0.607,13,42,0.31,10,14,0.714,117,46,85,0.541,26,43,0.605,20,42,0.476,24,28,0.857,136
160,MIN,2024-10-24,117,@,SAC,W 117-115,240,41,86,0.477,21,36,0.583,20,50,0.4,15,17,0.882,117,38,82,0.463,27,53,0.509,11,29,0.379,28,35,0.8,115
161,LAC,2024-11-17,116,,UTA,W 116-105,240,46,94,0.489,35,54,0.648,11,40,0.275,13,17,0.765,116,39,79,0.494,27,39,0.692,12,40,0.3,15,18,0.833,105
162,BOS,2024-11-12,116,,ATL,L 116-117,240,38,75,0.507,20,30,0.667,18,45,0.4,22,27,0.815,116,50,99,0.505,40,67,0.597,10,32,0.313,7,13,0.538,117
163,SAS,2024-11-11,116,,SAC,W 116-96,240,43,85,0.506,21,39,0.538,22,46,0.478,8,8,1,116,39,91,0.429,29,53,0.547,10,38,0.263,8,9,0.889,96
164,OKC,2024-11-10,116,,GSW,L 116-127,240,42,94,0.447,31,61,0.508,11,33,0.333,21,26,0.808,116,45,89,0.506,24,46,0.522,21,43,0.488,16,23,0.696,127
165,NYK,2024-11-08,116,,MIL,W 116-94,240,43,91,0.473,29,45,0.644,14,46,0.304,16,19,0.842,116,36,83,0.434,29,53,0.547,7,30,0.233,15,23,0.652,94
166,LAL,2024-11-08,116,,PHI,W 116-106,240,44,85,0.518,28,50,0.56,16,35,0.457,12,14,0.857,116,39,96,0.406,26,57,0.456,13,39,0.333,15,23,0.652,106
167,NYK,2024-11-06,116,@,ATL,L 116-121,240,41,84,0.488,19,37,0.514,22,47,0.468,12,15,0.8,116,45,100,0.45,30,62,0.484,15,38,0.395,16,22,0.727,121
168,PHI,2024-11-04,116,@,PHO,L 116-118,240,40,87,0.46,20,36,0.556,20,51,0.392,16,18,0.889,116,42,82,0.512,31,50,0.62,11,32,0.344,23,26,0.885,118
169,CLE,2024-11-04,116,,MIL,W 116-114,240,46,91,0.505,29,54,0.537,17,37,0.459,7,13,0.538,116,42,86,0.488,25,51,0.49,17,35,0.486,13,15,0.867,114
170,DEN,2024-11-01,116,@,MIN,L 116-119,240,41,92,0.446,30,60,0.5,11,32,0.344,23,29,0.793,116,43,83,0.518,25,41,0.61,18,42,0.429,15,18,0.833,119
171,NYK,2024-10-30,116,@,MIA,W 116-107,240,40,82,0.488,22,42,0.524,18,40,0.45,18,20,0.9,116,37,81,0.457,20,41,0.488,17,40,0.425,16,24,0.667,107
172,WAS,2024-10-26,116,,CLE,L 116-135,240,37,96,0.385,22,53,0.415,15,43,0.349,27,32,0.844,116,47,88,0.534,29,49,0.592,18,39,0.462,23,34,0.676,135
173,ORL,2024-10-25,116,,BRK,W 116-101,240,39,75,0.52,24,45,0.533,15,30,0.5,23,33,0.697,116,35,83,0.422,21,46,0.457,14,37,0.378,17,21,0.81,101
174,PHO,2024-10-25,116,@,LAL,L 116-123,240,42,82,0.512,25,45,0.556,17,37,0.459,15,17,0.882,116,40,75,0.533,26,48,0.542,14,27,0.519,29,39,0.744,123
175,ORL,2024-10-23,116,@,MIA,W 116-97,240,41,96,0.427,23,47,0.489,18,49,0.367,16,22,0.727,116,32,82,0.39,21,48,0.438,11,34,0.324,22,29,0.759,97
176,BRK,2024-10-23,116,@,ATL,L 116-120,240,40,91,0.44,23,48,0.479,17,43,0.395,19,25,0.76,116,39,80,0.488,30,52,0.577,9,28,0.321,33,46,0.717,120
177,PHO,2024-10-23,116,@,LAC,W 116-113 (OT),265,38,78,0.487,23,40,0.575,15,38,0.395,25,34,0.735,116,42,92,0.457,34,63,0.54,8,29,0.276,21,30,0.7,113
178,CHO,2024-11-16,115,,MIL,W 115-114,240,41,93,0.441,26,51,0.51,15,42,0.357,18,21,0.857,115,47,92,0.511,32,56,0.571,15,36,0.417,5,11,0.455,114
179,SAS,2024-11-15,115,,LAL,L 115-120,240,43,88,0.489,26,43,0.605,17,45,0.378,12,16,0.75,115,44,88,0.5,30,57,0.526,14,31,0.452,18,23,0.783,120
180,UTA,2024-11-14,115,,DAL,W 115-113,240,43,85,0.506,30,51,0.588,13,34,0.382,16,21,0.762,115,43,85,0.506,31,46,0.674,12,39,0.308,15,20,0.75,113
181,ORL,2024-11-08,115,,NOP,W 115-88,240,45,86,0.523,37,54,0.685,8,32,0.25,17,21,0.81,115,32,84,0.381,22,53,0.415,10,31,0.323,14,17,0.824,88
182,PHO,2024-11-06,115,,MIA,W 115-112,240,42,84,0.5,24,41,0.585,18,43,0.419,13,18,0.722,115,40,92,0.435,27,58,0.466,13,34,0.382,19,20,0.95,112
183,DET,2024-11-04,115,,LAL,W 115-103,240,45,96,0.469,37,62,0.597,8,34,0.235,17,22,0.773,115,37,85,0.435,28,60,0.467,9,25,0.36,20,27,0.741,103
184,ATL,2024-11-01,115,,SAC,L 115-123,240,41,92,0.446,22,42,0.524,19,50,0.38,14,18,0.778,115,43,89,0.483,32,56,0.571,11,33,0.333,26,30,0.867,123
185,IND,2024-10-28,115,@,ORL,L 115-119,240,41,88,0.466,28,59,0.475,13,29,0.448,20,30,0.667,115,39,83,0.47,26,42,0.619,13,41,0.317,28,38,0.737,119
186,BRK,2024-10-27,115,,MIL,W 115-102,240,39,91,0.429,23,46,0.5,16,45,0.356,21,23,0.913,115,33,74,0.446,23,41,0.561,10,33,0.303,26,31,0.839,102
187,TOR,2024-10-25,115,,PHI,W 115-107,240,35,76,0.461,29,53,0.547,6,23,0.261,39,46,0.848,115,29,76,0.382,20,47,0.426,9,29,0.31,40,53,0.755,107
188,SAC,2024-10-24,115,,MIN,L 115-117,240,38,82,0.463,27,53,0.509,11,29,0.379,28,35,0.8,115,41,86,0.477,21,36,0.583,20,50,0.4,15,17,0.882,117
189,IND,2024-10-23,115,@,DET,W 115-109,240,42,83,0.506,33,52,0.635,9,31,0.29,22,25,0.88,115,38,88,0.432,29,55,0.527,9,33,0.273,24,28,0.857,109
190,CHO,2024-11-17,114,@,CLE,L 114-128,240,42,103,0.408,22,51,0.431,20,52,0.385,10,12,0.833,114,44,77,0.571,31,47,0.66,13,30,0.433,27,28,0.964,128
191,NYK,2024-11-17,114,,BRK,W 114-104,240,43,88,0.489,30,48,0.625,13,40,0.325,15,19,0.789,114,32,76,0.421,15,35,0.429,17,41,0.415,23,30,0.767,104
192,POR,2024-11-17,114,,ATL,W 114-110,240,44,95,0.463,30,57,0.526,14,38,0.368,12,19,0.632,114,39,85,0.459,28,53,0.528,11,32,0.344,21,25,0.84,110
193,MIL,2024-11-16,114,@,CHO,L 114-115,240,47,92,0.511,32,56,0.571,15,36,0.417,5,11,0.455,114,41,93,0.441,26,51,0.51,15,42,0.357,18,21,0.857,115
194,BRK,2024-11-13,114,,BOS,L 114-139,240,40,79,0.506,21,36,0.583,19,43,0.442,15,18,0.833,114,50,93,0.538,28,47,0.596,22,46,0.478,17,24,0.708,139
195,CLE,2024-11-13,114,@,PHI,W 114-106,240,42,85,0.494,26,45,0.578,16,40,0.4,14,17,0.824,114,41,92,0.446,27,49,0.551,14,43,0.326,10,11,0.909,106
196,ORL,2024-11-12,114,,CHO,W 114-89,240,43,93,0.462,30,49,0.612,13,44,0.295,15,19,0.789,114,34,84,0.405,21,46,0.457,13,38,0.342,8,14,0.571,89
197,PHO,2024-11-08,114,@,DAL,W 114-113,240,43,86,0.5,28,47,0.596,15,39,0.385,13,18,0.722,114,41,80,0.513,30,47,0.638,11,33,0.333,20,22,0.909,113
198,LAL,2024-11-06,114,@,MEM,L 114-131,240,41,93,0.441,26,45,0.578,15,48,0.313,17,21,0.81,114,48,93,0.516,31,59,0.525,17,34,0.5,18,23,0.783,131
199,MIN,2024-11-04,114,,CHO,W 114-93,240,39,79,0.494,21,41,0.512,18,38,0.474,18,26,0.692,114,35,88,0.398,25,46,0.543,10,42,0.238,13,16,0.813,93
200,MIL,2024-11-04,114,@,CLE,L 114-116,240,42,86,0.488,25,51,0.49,17,35,0.486,13,15,0.867,114,46,91,0.505,29,54,0.537,17,37,0.459,7,13,0.538,116
201,CLE,2024-11-02,114,@,MIL,W 114-113,240,44,91,0.484,29,53,0.547,15,38,0.395,11,15,0.733,114,43,89,0.483,25,50,0.5,18,39,0.462,9,15,0.6,113
202,POR,2024-11-01,114,,OKC,L 114-137,240,39,83,0.47,24,48,0.5,15,35,0.429,21,31,0.677,114,51,95,0.537,32,46,0.696,19,49,0.388,16,19,0.842,137
203,MIN,2024-10-29,114,,DAL,L 114-120,240,39,77,0.506,20,38,0.526,19,39,0.487,17,26,0.654,114,45,93,0.484,29,54,0.537,16,39,0.41,14,18,0.778,120
204,IND,2024-10-27,114,,PHI,L 114-118 (OT),265,39,84,0.464,26,52,0.5,13,32,0.406,23,34,0.676,114,42,98,0.429,31,56,0.554,11,42,0.262,23,31,0.742,118
205,MIA,2024-10-26,114,@,CHO,W 114-106,240,40,86,0.465,26,52,0.5,14,34,0.412,20,28,0.714,114,39,89,0.438,26,48,0.542,13,41,0.317,15,21,0.714,106
206,OKC,2024-10-26,114,@,CHI,W 114-95,240,45,107,0.421,37,67,0.552,8,40,0.2,16,20,0.8,114,32,92,0.348,17,39,0.436,15,53,0.283,16,22,0.727,95
207,PHO,2024-10-26,114,,DAL,W 114-102,240,36,80,0.45,22,41,0.537,14,39,0.359,28,37,0.757,114,37,93,0.398,24,52,0.462,13,41,0.317,15,18,0.833,102
208,DAL,2024-11-14,113,@,UTA,L 113-115,240,43,85,0.506,31,46,0.674,12,39,0.308,15,20,0.75,113,43,85,0.506,30,51,0.588,13,34,0.382,16,21,0.762,115
209,CHI,2024-11-11,113,,CLE,L 113-119,240,43,87,0.494,29,49,0.592,14,38,0.368,13,16,0.813,113,43,97,0.443,28,52,0.538,15,45,0.333,18,24,0.75,119
210,BOS,2024-11-10,113,@,MIL,W 113-107,240,35,86,0.407,16,36,0.444,19,50,0.38,24,27,0.889,113,39,81,0.481,26,49,0.531,13,32,0.406,16,21,0.762,107
211,ATL,2024-11-09,113,,CHI,L 113-125,240,41,89,0.461,32,60,0.533,9,29,0.31,22,30,0.733,113,46,92,0.5,33,53,0.623,13,39,0.333,20,23,0.87,125
212,DAL,2024-11-08,113,,PHO,L 113-114,240,41,80,0.513,30,47,0.638,11,33,0.333,20,22,0.909,113,43,86,0.5,28,47,0.596,15,39,0.385,13,18,0.722,114
213,LAC,2024-11-04,113,,SAS,W 113-104,240,41,90,0.456,22,53,0.415,19,37,0.514,12,17,0.706,113,38,86,0.442,27,45,0.6,11,41,0.268,17,19,0.895,104
214,MIL,2024-11-02,113,,CLE,L 113-114,240,43,89,0.483,25,50,0.5,18,39,0.462,9,15,0.6,113,44,91,0.484,29,53,0.547,15,38,0.395,11,15,0.733,114
215,BOS,2024-11-02,113,@,CHO,W 113-103,240,36,82,0.439,20,30,0.667,16,52,0.308,25,28,0.893,113,40,91,0.44,23,49,0.469,17,42,0.405,6,9,0.667,103
216,SAS,2024-11-02,113,,MIN,W 113-103,240,43,83,0.518,30,41,0.732,13,42,0.31,14,17,0.824,113,39,82,0.476,28,45,0.622,11,37,0.297,14,20,0.7,103
217,SAC,2024-10-29,113,@,UTA,W 113-96,240,48,92,0.522,40,61,0.656,8,31,0.258,9,14,0.643,113,35,89,0.393,21,41,0.512,14,48,0.292,12,14,0.857,96
218,CLE,2024-10-25,113,,DET,W 113-101,240,42,82,0.512,29,48,0.604,13,34,0.382,16,23,0.696,113,38,81,0.469,25,49,0.51,13,32,0.406,12,17,0.706,101
219,LAC,2024-10-23,113,,PHO,L 113-116 (OT),265,42,92,0.457,34,63,0.54,8,29,0.276,21,30,0.7,113,38,78,0.487,23,40,0.575,15,38,0.395,25,34,0.735,116
220,UTA,2024-11-12,112,,PHO,L 112-120,240,45,92,0.489,30,54,0.556,15,38,0.395,7,9,0.778,112,43,86,0.5,25,47,0.532,18,39,0.462,16,22,0.727,120
221,MIA,2024-11-06,112,@,PHO,L 112-115,240,40,92,0.435,27,58,0.466,13,34,0.382,19,20,0.95,112,42,84,0.5,24,41,0.585,18,43,0.419,13,18,0.722,115
222,BOS,2024-11-06,112,,GSW,L 112-118,240,38,90,0.422,19,36,0.528,19,54,0.352,17,21,0.81,112,42,91,0.462,28,57,0.491,14,34,0.412,20,24,0.833,118
223,WAS,2024-11-04,112,,GSW,L 112-125,240,42,96,0.438,32,53,0.604,10,43,0.233,18,21,0.857,112,44,97,0.454,32,60,0.533,12,37,0.324,25,34,0.735,125
224,CHI,2024-11-01,112,@,BRK,L 112-120,240,38,88,0.432,21,44,0.477,17,44,0.386,19,24,0.792,112,49,94,0.521,38,58,0.655,11,36,0.306,11,13,0.846,120
225,LAC,2024-10-27,112,@,GSW,W 112-104,240,42,90,0.467,32,58,0.552,10,32,0.313,18,23,0.783,112,38,88,0.432,24,45,0.533,14,43,0.326,14,22,0.636,104
226,MIN,2024-10-26,112,,TOR,W 112-101,240,39,83,0.47,25,46,0.543,14,37,0.378,20,26,0.769,112,41,90,0.456,31,61,0.508,10,29,0.345,9,13,0.692,101
227,IND,2024-11-15,111,,MIA,L 111-124,240,44,86,0.512,30,51,0.588,14,35,0.4,9,11,0.818,111,45,87,0.517,30,45,0.667,15,42,0.357,19,23,0.826,124
228,HOU,2024-11-13,111,,LAC,W 111-103,240,42,97,0.433,27,57,0.474,15,40,0.375,12,17,0.706,111,38,96,0.396,24,58,0.414,14,38,0.368,13,16,0.813,103
229,NYK,2024-11-12,111,@,PHI,W 111-99,240,44,89,0.494,35,58,0.603,9,31,0.29,14,15,0.933,111,31,83,0.373,17,41,0.415,14,42,0.333,23,24,0.958,99
230,UTA,2024-11-09,111,@,SAS,W 111-110,240,38,82,0.463,28,49,0.571,10,33,0.303,25,35,0.714,111,38,85,0.447,21,38,0.553,17,47,0.362,17,19,0.895,110
231,ORL,2024-11-06,111,@,IND,L 111-118,240,42,82,0.512,35,57,0.614,7,25,0.28,20,26,0.769,111,41,76,0.539,29,50,0.58,12,26,0.462,24,26,0.923,118
232,SAC,2024-11-04,111,@,MIA,W 111-110,240,44,86,0.512,34,59,0.576,10,27,0.37,13,15,0.867,111,37,85,0.435,22,49,0.449,15,36,0.417,21,30,0.7,110
233,NOP,2024-11-03,111,,ATL,L 111-126,240,39,90,0.433,23,52,0.442,16,38,0.421,17,20,0.85,111,50,88,0.568,35,52,0.673,15,36,0.417,11,12,0.917,126
234,SAC,2024-10-28,111,,POR,W 111-98,240,37,81,0.457,23,46,0.5,14,35,0.4,23,25,0.92,111,35,83,0.422,31,61,0.508,4,22,0.182,24,30,0.8,98
235,ORL,2024-10-26,111,@,MEM,L 111-124,240,37,87,0.425,20,39,0.513,17,48,0.354,20,28,0.714,111,46,86,0.535,33,52,0.635,13,34,0.382,19,24,0.792,124
236,CHI,2024-10-23,111,@,NOP,L 111-123,240,42,86,0.488,32,52,0.615,10,34,0.294,17,25,0.68,111,45,97,0.464,31,60,0.517,14,37,0.378,19,21,0.905,123
237,MIA,2024-11-17,110,@,IND,L 110-119,240,36,90,0.4,17,47,0.362,19,43,0.442,19,20,0.95,110,44,85,0.518,31,56,0.554,13,29,0.448,18,20,0.9,119
238,ATL,2024-11-17,110,@,POR,L 110-114,240,39,85,0.459,28,53,0.528,11,32,0.344,21,25,0.84,110,44,95,0.463,30,57,0.526,14,38,0.368,12,19,0.632,114
239,DAL,2024-11-16,110,,SAS,W 110-93,240,44,94,0.468,36,63,0.571,8,31,0.258,14,18,0.778,110,28,88,0.318,17,48,0.354,11,40,0.275,26,30,0.867,93
240,SAS,2024-11-09,110,,UTA,L 110-111,240,38,85,0.447,21,38,0.553,17,47,0.362,17,19,0.895,110,38,82,0.463,28,49,0.571,10,33,0.303,25,35,0.714,111
241,LAC,2024-11-06,110,,PHI,W 110-98,240,41,72,0.569,29,44,0.659,12,28,0.429,16,19,0.842,110,40,73,0.548,33,48,0.688,7,25,0.28,11,19,0.579,98
242,MIA,2024-11-04,110,,SAC,L 110-111,240,37,85,0.435,22,49,0.449,15,36,0.417,21,30,0.7,110,44,86,0.512,34,59,0.576,10,27,0.37,13,15,0.867,111
243,LAL,2024-10-30,110,@,CLE,L 110-134,240,38,77,0.494,32,49,0.653,6,28,0.214,28,33,0.848,110,56,97,0.577,39,56,0.696,17,41,0.415,5,8,0.625,134
244,DAL,2024-10-28,110,,UTA,W 110-102,240,43,95,0.453,32,56,0.571,11,39,0.282,13,17,0.765,110,34,92,0.37,24,57,0.421,10,35,0.286,24,29,0.828,102
245,CLE,2024-10-28,110,@,NYK,W 110-104,240,39,82,0.476,27,46,0.587,12,36,0.333,20,24,0.833,110,40,90,0.444,31,62,0.5,9,28,0.321,15,18,0.833,104
246,CHO,2024-10-23,110,@,HOU,W 110-105,240,38,85,0.447,23,46,0.5,15,39,0.385,19,24,0.792,110,38,103,0.369,25,60,0.417,13,43,0.302,16,20,0.8,105
247,LAL,2024-10-22,110,,MIN,W 110-103,240,42,95,0.442,37,65,0.569,5,30,0.167,21,25,0.84,110,35,85,0.412,22,44,0.5,13,41,0.317,20,27,0.741,103
248,HOU,2024-11-04,109,,NYK,W 109-97,240,43,88,0.489,35,55,0.636,8,33,0.242,15,18,0.833,109,34,88,0.386,23,60,0.383,11,28,0.393,18,21,0.857,97
249,CHO,2024-11-01,109,,BOS,L 109-124,240,42,91,0.462,23,43,0.535,19,48,0.396,6,12,0.5,109,41,86,0.477,28,44,0.636,13,42,0.31,29,35,0.829,124
250,ORL,2024-11-01,109,@,CLE,L 109-120,240,41,90,0.456,30,57,0.526,11,33,0.333,16,24,0.667,109,44,87,0.506,29,49,0.592,15,38,0.395,17,20,0.85,120
251,PHO,2024-10-28,109,,LAL,W 109-105,240,40,87,0.46,29,51,0.569,11,36,0.306,18,20,0.9,109,39,94,0.415,25,62,0.403,14,32,0.438,13,18,0.722,105
252,LAC,2024-10-26,109,@,DEN,W 109-104,240,40,82,0.488,28,49,0.571,12,33,0.364,17,21,0.81,109,35,87,0.402,21,52,0.404,14,35,0.4,20,24,0.833,104
253,SAS,2024-10-26,109,,HOU,W 109-106,240,39,79,0.494,31,59,0.525,8,20,0.4,23,28,0.821,109,38,92,0.413,25,51,0.49,13,41,0.317,17,21,0.81,106
254,SAS,2024-10-24,109,@,DAL,L 109-120,240,39,86,0.453,27,50,0.54,12,36,0.333,19,24,0.792,109,42,102,0.412,23,58,0.397,19,44,0.432,17,23,0.739,120
255,PHI,2024-10-23,109,,MIL,L 109-124,240,41,98,0.418,33,67,0.493,8,31,0.258,19,27,0.704,109,43,80,0.538,27,43,0.628,16,37,0.432,22,31,0.71,124
256,DET,2024-10-23,109,,IND,L 109-115,240,38,88,0.432,29,55,0.527,9,33,0.273,24,28,0.857,109,42,83,0.506,33,52,0.635,9,31,0.29,22,25,0.88,115
257,NYK,2024-10-22,109,@,BOS,L 109-132,240,43,78,0.551,32,48,0.667,11,30,0.367,12,16,0.75,109,48,95,0.505,19,34,0.559,29,61,0.475,7,8,0.875,132
258,MIN,2024-11-12,108,@,POR,L 108-122,240,37,73,0.507,24,38,0.632,13,35,0.371,21,23,0.913,108,43,84,0.512,25,52,0.481,18,32,0.563,18,20,0.9,122
259,BOS,2024-11-08,108,,BRK,W 108-104 (OT),265,39,90,0.433,25,37,0.676,14,53,0.264,16,19,0.842,108,41,100,0.41,31,62,0.5,10,38,0.263,12,15,0.8,104
260,CHO,2024-11-06,108,,DET,W 108-107,240,39,90,0.433,25,46,0.543,14,44,0.318,16,16,1,108,46,94,0.489,36,62,0.581,10,32,0.313,5,9,0.556,107
261,DAL,2024-11-03,108,,ORL,W 108-85,240,42,85,0.494,32,53,0.604,10,32,0.313,14,23,0.609,108,31,93,0.333,23,52,0.442,8,41,0.195,15,19,0.789,85
262,HOU,2024-10-31,108,@,DAL,W 108-102,240,40,97,0.412,32,63,0.508,8,34,0.235,20,27,0.741,108,39,85,0.459,29,55,0.527,10,30,0.333,14,20,0.7,102
263,MIL,2024-10-28,108,@,BOS,L 108-119,240,37,82,0.451,29,51,0.569,8,31,0.258,26,31,0.839,108,43,87,0.494,25,40,0.625,18,47,0.383,15,19,0.789,119
264,MEM,2024-10-25,108,@,HOU,L 108-128,240,38,91,0.418,28,63,0.444,10,28,0.357,22,36,0.611,108,43,98,0.439,26,55,0.473,17,43,0.395,25,36,0.694,128
265,CHI,2024-11-17,107,,HOU,L 107-143,240,36,107,0.336,22,51,0.431,14,56,0.25,21,22,0.955,107,55,105,0.524,45,71,0.634,10,34,0.294,23,32,0.719,143
266,HOU,2024-11-11,107,,WAS,W 107-92,240,40,87,0.46,35,64,0.547,5,23,0.217,22,25,0.88,107,36,88,0.409,25,57,0.439,11,31,0.355,9,13,0.692,92
267,BRK,2024-11-11,107,@,NOP,W 107-105,240,36,84,0.429,17,42,0.405,19,42,0.452,16,19,0.842,107,42,94,0.447,32,64,0.5,10,30,0.333,11,12,0.917,105
268,PHI,2024-11-10,107,,CHO,W 107-105 (OT),265,39,84,0.464,30,51,0.588,9,33,0.273,20,26,0.769,107,36,95,0.379,22,41,0.537,14,54,0.259,19,22,0.864,105
269,MIL,2024-11-10,107,,BOS,L 107-113,240,39,81,0.481,26,49,0.531,13,32,0.406,16,21,0.762,107,35,86,0.407,16,36,0.444,19,50,0.38,24,27,0.889,113
270,HOU,2024-11-08,107,@,OKC,L 107-126,240,39,90,0.433,28,60,0.467,11,30,0.367,18,26,0.692,107,46,90,0.511,32,53,0.604,14,37,0.378,20,23,0.87,126
271,LAC,2024-11-08,107,@,SAC,W 107-98,240,36,81,0.444,22,51,0.431,14,30,0.467,21,23,0.913,107,37,78,0.474,34,52,0.654,3,26,0.115,21,24,0.875,98
272,TOR,2024-11-06,107,@,SAC,L 107-122,240,43,88,0.489,33,54,0.611,10,34,0.294,11,15,0.733,107,42,90,0.467,32,55,0.582,10,35,0.286,28,32,0.875,122
273,DET,2024-11-06,107,@,CHO,L 107-108,240,46,94,0.489,36,62,0.581,10,32,0.313,5,9,0.556,107,39,90,0.433,25,46,0.543,14,44,0.318,16,16,1,108
274,PHI,2024-11-02,107,,MEM,L 107-124,240,36,89,0.404,17,43,0.395,19,46,0.413,16,20,0.8,107,48,87,0.552,36,60,0.6,12,27,0.444,16,21,0.762,124
275,MIA,2024-10-30,107,,NYK,L 107-116,240,37,81,0.457,20,41,0.488,17,40,0.425,16,24,0.667,107,40,82,0.488,22,42,0.524,18,40,0.45,18,20,0.9,116
276,PHI,2024-10-25,107,@,TOR,L 107-115,240,29,76,0.382,20,47,0.426,9,29,0.31,40,53,0.755,107,35,76,0.461,29,53,0.547,6,23,0.261,39,46,0.848,115
277,PHI,2024-11-13,106,,CLE,L 106-114,240,41,92,0.446,27,49,0.551,14,43,0.326,10,11,0.909,106,42,85,0.494,26,45,0.578,16,40,0.4,14,17,0.824,114
278,POR,2024-11-13,106,,MIN,W 106-98,240,38,83,0.458,29,58,0.5,9,25,0.36,21,23,0.913,106,37,94,0.394,30,55,0.545,7,39,0.179,17,22,0.773,98
279,OKC,2024-11-13,106,,NOP,W 106-88,240,39,88,0.443,24,49,0.49,15,39,0.385,13,16,0.813,106,34,86,0.395,25,49,0.51,9,37,0.243,11,17,0.647,88
280,PHI,2024-11-08,106,@,LAL,L 106-116,240,39,96,0.406,26,57,0.456,13,39,0.333,15,23,0.652,106,44,85,0.518,28,50,0.56,16,35,0.457,12,14,0.857,116
281,BRK,2024-11-04,106,,MEM,W 106-104,240,40,84,0.476,27,48,0.563,13,36,0.361,13,18,0.722,106,43,91,0.473,35,61,0.574,8,30,0.267,10,13,0.769,104
282,DET,2024-11-03,106,@,BRK,W 106-92,240,37,77,0.481,26,41,0.634,11,36,0.306,21,26,0.808,106,32,71,0.451,23,40,0.575,9,31,0.29,19,31,0.613,92
283,SAS,2024-10-31,106,@,UTA,W 106-88,240,38,92,0.413,26,49,0.531,12,43,0.279,18,23,0.783,106,32,82,0.39,25,50,0.5,7,32,0.219,17,19,0.895,88
284,POR,2024-10-30,106,@,LAC,W 106-105,240,41,92,0.446,27,59,0.458,14,33,0.424,10,12,0.833,106,41,90,0.456,28,54,0.519,13,36,0.361,10,18,0.556,105
285,MEM,2024-10-30,106,,BRK,L 106-119,240,38,81,0.469,30,54,0.556,8,27,0.296,22,29,0.759,106,41,80,0.513,26,39,0.667,15,41,0.366,22,25,0.88,119
286,NOP,2024-10-29,106,@,GSW,L 106-124,240,40,74,0.541,31,52,0.596,9,22,0.409,17,24,0.708,106,46,97,0.474,25,51,0.49,21,46,0.457,11,13,0.846,124
287,HOU,2024-10-28,106,@,SAS,W 106-101,240,35,85,0.412,20,48,0.417,15,37,0.405,21,24,0.875,106,37,87,0.425,27,54,0.5,10,33,0.303,17,21,0.81,101
288,MIA,2024-10-28,106,,DET,W 106-98,240,38,88,0.432,23,41,0.561,15,47,0.319,15,20,0.75,106,35,91,0.385,21,53,0.396,14,38,0.368,14,17,0.824,98
289,HOU,2024-10-26,106,@,SAS,L 106-109,240,38,92,0.413,25,51,0.49,13,41,0.317,17,21,0.81,106,39,79,0.494,31,59,0.525,8,20,0.4,23,28,0.821,109
290,CHO,2024-10-26,106,,MIA,L 106-114,240,39,89,0.438,26,48,0.542,13,41,0.317,15,21,0.714,106,40,86,0.465,26,52,0.5,14,34,0.412,20,28,0.714,114
291,TOR,2024-10-23,106,,CLE,L 106-136,240,36,86,0.419,24,55,0.436,12,31,0.387,22,29,0.759,106,51,87,0.586,37,57,0.649,14,30,0.467,20,26,0.769,136
292,UTA,2024-11-17,105,@,LAC,L 105-116,240,39,79,0.494,27,39,0.692,12,40,0.3,15,18,0.833,105,46,94,0.489,35,54,0.648,11,40,0.275,13,17,0.765,116
293,MEM,2024-11-17,105,,DEN,W 105-90,240,41,91,0.451,28,52,0.538,13,39,0.333,10,12,0.833,105,35,84,0.417,25,53,0.472,10,31,0.323,10,14,0.714,90
294,NOP,2024-11-11,105,,BRK,L 105-107,240,42,94,0.447,32,64,0.5,10,30,0.333,11,12,0.917,105,36,84,0.429,17,42,0.405,19,42,0.452,16,19,0.842,107
295,CHO,2024-11-10,105,@,PHI,L 105-107 (OT),265,36,95,0.379,22,41,0.537,14,54,0.259,19,22,0.864,105,39,84,0.464,30,51,0.588,9,33,0.273,20,26,0.769,107
296,LAC,2024-11-09,105,,TOR,W 105-103,240,35,76,0.461,25,50,0.5,10,26,0.385,25,32,0.781,105,40,95,0.421,29,58,0.5,11,37,0.297,12,21,0.571,103
297,CLE,2024-11-09,105,,BRK,W 105-100,240,40,74,0.541,30,46,0.652,10,28,0.357,15,19,0.789,105,34,76,0.447,19,33,0.576,15,43,0.349,17,18,0.944,100
298,POR,2024-11-07,105,@,SAS,L 105-118,240,41,86,0.477,32,54,0.593,9,32,0.281,14,22,0.636,105,44,82,0.537,28,43,0.651,16,39,0.41,14,18,0.778,118
299,OKC,2024-11-02,105,@,LAC,W 105-92,240,36,84,0.429,20,45,0.444,16,39,0.41,17,19,0.895,105,32,79,0.405,21,44,0.477,11,35,0.314,17,26,0.654,92
300,LAC,2024-10-30,105,,POR,L 105-106,240,41,90,0.456,28,54,0.519,13,36,0.361,10,18,0.556,105,41,92,0.446,27,59,0.458,14,33,0.424,10,12,0.833,106
301,OKC,2024-10-30,105,,SAS,W 105-93,240,41,89,0.461,24,48,0.5,17,41,0.415,6,8,0.75,105,35,85,0.412,23,49,0.469,12,36,0.333,11,13,0.846,93
302,DET,2024-10-30,105,@,PHI,W 105-95,240,36,78,0.462,21,42,0.5,15,36,0.417,18,22,0.818,105,33,79,0.418,25,51,0.49,8,28,0.286,21,28,0.75,95
303,LAL,2024-10-28,105,@,PHO,L 105-109,240,39,94,0.415,25,62,0.403,14,32,0.438,13,18,0.722,105,40,87,0.46,29,51,0.569,11,36,0.306,18,20,0.9,109
304,NOP,2024-10-25,105,@,POR,W 105-103,240,36,86,0.419,24,54,0.444,12,32,0.375,21,31,0.677,105,37,90,0.411,24,53,0.453,13,37,0.351,16,20,0.8,103
305,HOU,2024-10-23,105,,CHO,L 105-110,240,38,103,0.369,25,60,0.417,13,43,0.302,16,20,0.8,105,38,85,0.447,23,46,0.5,15,39,0.385,19,24,0.792,110
306,BRK,2024-11-17,104,@,NYK,L 104-114,240,32,76,0.421,15,35,0.429,17,41,0.415,23,30,0.767,104,43,88,0.489,30,48,0.625,13,40,0.325,15,19,0.789,114
307,WAS,2024-11-17,104,,DET,L 104-124,240,39,83,0.47,27,56,0.482,12,27,0.444,14,20,0.7,104,46,97,0.474,29,59,0.492,17,38,0.447,15,19,0.789,124
308,LAL,2024-11-16,104,@,NOP,W 104-99,240,39,89,0.438,27,49,0.551,12,40,0.3,14,18,0.778,104,35,83,0.422,24,54,0.444,11,29,0.379,18,23,0.783,99
309,LAC,2024-11-15,104,@,HOU,L 104-125,240,34,90,0.378,24,50,0.48,10,40,0.25,26,33,0.788,104,46,95,0.484,27,51,0.529,19,44,0.432,14,18,0.778,125
310,PHO,2024-11-13,104,@,SAC,L 104-127,240,36,97,0.371,23,54,0.426,13,43,0.302,19,26,0.731,104,50,78,0.641,35,50,0.7,15,28,0.536,12,17,0.706,127
311,BRK,2024-11-08,104,@,BOS,L 104-108 (OT),265,41,100,0.41,31,62,0.5,10,38,0.263,12,15,0.8,104,39,90,0.433,25,37,0.676,14,53,0.264,16,19,0.842,108
312,WAS,2024-11-08,104,@,MEM,L 104-128,240,38,93,0.409,29,58,0.5,9,35,0.257,19,23,0.826,104,46,97,0.474,32,54,0.593,14,43,0.326,22,25,0.88,128
313,SAS,2024-11-04,104,@,LAC,L 104-113,240,38,86,0.442,27,45,0.6,11,41,0.268,17,19,0.895,104,41,90,0.456,22,53,0.415,19,37,0.514,12,17,0.706,113
314,MEM,2024-11-04,104,@,BRK,L 104-106,240,43,91,0.473,35,61,0.574,8,30,0.267,10,13,0.769,104,40,84,0.476,27,48,0.563,13,36,0.361,13,18,0.722,106
315,GSW,2024-10-30,104,,NOP,W 104-89,240,41,87,0.471,28,49,0.571,13,38,0.342,9,13,0.692,104,33,90,0.367,22,54,0.407,11,36,0.306,12,20,0.6,89
316,NYK,2024-10-28,104,,CLE,L 104-110,240,40,90,0.444,31,62,0.5,9,28,0.321,15,18,0.833,104,39,82,0.476,27,46,0.587,12,36,0.333,20,24,0.833,110
317,GSW,2024-10-27,104,,LAC,L 104-112,240,38,88,0.432,24,45,0.533,14,43,0.326,14,22,0.636,104,42,90,0.467,32,58,0.552,10,32,0.313,18,23,0.783,112
318,ATL,2024-10-27,104,@,OKC,L 104-128,240,36,91,0.396,26,60,0.433,10,31,0.323,22,29,0.759,104,44,89,0.494,28,49,0.571,16,40,0.4,24,32,0.75,128
319,DEN,2024-10-26,104,,LAC,L 104-109,240,35,87,0.402,21,52,0.404,14,35,0.4,20,24,0.833,104,40,82,0.488,28,49,0.571,12,33,0.364,17,21,0.81,109
320,POR,2024-10-23,104,,GSW,L 104-140,240,36,92,0.391,28,58,0.483,8,34,0.235,24,30,0.8,104,48,93,0.516,28,45,0.622,20,48,0.417,24,30,0.8,140
321,LAC,2024-11-13,103,@,HOU,L 103-111,240,38,96,0.396,24,58,0.414,14,38,0.368,13,16,0.813,103,42,97,0.433,27,57,0.474,15,40,0.375,12,17,0.706,111
322,TOR,2024-11-10,103,@,LAL,L 103-123,240,37,82,0.451,27,53,0.509,10,29,0.345,19,22,0.864,103,44,86,0.512,32,49,0.653,12,37,0.324,23,28,0.821,123
323,TOR,2024-11-09,103,@,LAC,L 103-105,240,40,95,0.421,29,58,0.5,11,37,0.297,12,21,0.571,103,35,76,0.461,25,50,0.5,10,26,0.385,25,32,0.781,105
324,CHO,2024-11-08,103,,IND,W 103-83,240,38,90,0.422,21,40,0.525,17,50,0.34,10,12,0.833,103,33,83,0.398,24,54,0.444,9,29,0.31,8,14,0.571,83
325,LAL,2024-11-04,103,@,DET,L 103-115,240,37,85,0.435,28,60,0.467,9,25,0.36,20,27,0.741,103,45,96,0.469,37,62,0.597,8,34,0.235,17,22,0.773,115
326,UTA,2024-11-02,103,@,DEN,L 103-129,240,32,77,0.416,19,35,0.543,13,42,0.31,26,31,0.839,103,48,99,0.485,32,67,0.478,16,32,0.5,17,23,0.739,129
327,CHO,2024-11-02,103,,BOS,L 103-113,240,40,91,0.44,23,49,0.469,17,42,0.405,6,9,0.667,103,36,82,0.439,20,30,0.667,16,52,0.308,25,28,0.893,113
328,PHO,2024-11-02,103,,POR,W 103-97,240,35,93,0.376,18,41,0.439,17,52,0.327,16,22,0.727,103,37,111,0.333,23,68,0.338,14,43,0.326,9,11,0.818,97
329,MIN,2024-11-02,103,@,SAS,L 103-113,240,39,82,0.476,28,45,0.622,11,37,0.297,14,20,0.7,103,43,83,0.518,30,41,0.732,13,42,0.31,14,17,0.824,113
330,NOP,2024-10-27,103,@,POR,L 103-125,240,38,88,0.432,30,59,0.508,8,29,0.276,19,24,0.792,103,43,93,0.462,29,58,0.5,14,35,0.4,25,32,0.781,125
331,POR,2024-10-25,103,,NOP,L 103-105,240,37,90,0.411,24,53,0.453,13,37,0.351,16,20,0.8,103,36,86,0.419,24,54,0.444,12,32,0.375,21,31,0.677,105
332,MIN,2024-10-22,103,@,LAL,L 103-110,240,35,85,0.412,22,44,0.5,13,41,0.317,20,27,0.741,103,42,95,0.442,37,65,0.569,5,30,0.167,21,25,0.84,110
333,POR,2024-11-08,102,@,MIN,L 102-127,240,39,91,0.429,33,66,0.5,6,25,0.24,18,24,0.75,102,47,97,0.485,25,47,0.532,22,50,0.44,11,14,0.786,127
334,OKC,2024-11-04,102,,ORL,W 102-86,240,39,85,0.459,27,54,0.5,12,31,0.387,12,16,0.75,102,29,82,0.354,24,48,0.5,5,34,0.147,23,27,0.852,86
335,DAL,2024-10-31,102,,HOU,L 102-108,240,39,85,0.459,29,55,0.527,10,30,0.333,14,20,0.7,102,40,97,0.412,32,63,0.508,8,34,0.235,20,27,0.741,108
336,CHI,2024-10-30,102,,ORL,W 102-99,240,36,84,0.429,23,50,0.46,13,34,0.382,17,25,0.68,102,35,86,0.407,24,40,0.6,11,46,0.239,18,20,0.9,99
337,UTA,2024-10-28,102,@,DAL,L 102-110,240,34,92,0.37,24,57,0.421,10,35,0.286,24,29,0.828,102,43,95,0.453,32,56,0.571,11,39,0.282,13,17,0.765,110
338,MIL,2024-10-27,102,@,BRK,L 102-115,240,33,74,0.446,23,41,0.561,10,33,0.303,26,31,0.839,102,39,91,0.429,23,46,0.5,16,45,0.356,21,23,0.913,115
339,DAL,2024-10-26,102,@,PHO,L 102-114,240,37,93,0.398,24,52,0.462,13,41,0.317,15,18,0.833,102,36,80,0.45,22,41,0.537,14,39,0.359,28,37,0.757,114
340,OKC,2024-10-24,102,@,DEN,W 102-87,240,43,101,0.426,35,65,0.538,8,36,0.222,8,12,0.667,102,35,98,0.357,28,60,0.467,7,38,0.184,10,14,0.714,87
341,WAS,2024-10-24,102,,BOS,L 102-122,240,41,95,0.432,34,59,0.576,7,36,0.194,13,18,0.722,102,42,90,0.467,25,45,0.556,17,45,0.378,21,27,0.778,122
342,NOP,2024-11-15,101,,DEN,W 101-94,240,37,87,0.425,26,52,0.5,11,35,0.314,16,18,0.889,101,37,87,0.425,27,50,0.54,10,37,0.27,10,11,0.909,94
343,HOU,2024-11-10,101,@,DET,W 101-99,240,38,93,0.409,31,59,0.525,7,34,0.206,18,24,0.75,101,36,84,0.429,25,50,0.5,11,34,0.324,16,23,0.696,99
344,SAS,2024-10-28,101,,HOU,L 101-106,240,37,87,0.425,27,54,0.5,10,33,0.303,17,21,0.81,101,35,85,0.412,20,48,0.417,15,37,0.405,21,24,0.875,106
345,TOR,2024-10-26,101,@,MIN,L 101-112,240,41,90,0.456,31,61,0.508,10,29,0.345,9,13,0.692,101,39,83,0.47,25,46,0.543,14,37,0.378,20,26,0.769,112
346,BRK,2024-10-25,101,@,ORL,L 101-116,240,35,83,0.422,21,46,0.457,14,37,0.378,17,21,0.81,101,39,75,0.52,24,45,0.533,15,30,0.5,23,33,0.697,116
347,DET,2024-10-25,101,@,CLE,L 101-113,240,38,81,0.469,25,49,0.51,13,32,0.406,12,17,0.706,101,42,82,0.512,29,48,0.604,13,34,0.382,16,23,0.696,113
348,BRK,2024-11-09,100,@,CLE,L 100-105,240,34,76,0.447,19,33,0.576,15,43,0.349,17,18,0.944,100,40,74,0.541,30,46,0.652,10,28,0.357,15,19,0.789,105
349,UTA,2024-11-07,100,@,MIL,L 100-123,240,33,77,0.429,16,36,0.444,17,41,0.415,17,18,0.944,100,43,84,0.512,28,49,0.571,15,35,0.429,22,30,0.733,123
350,SAS,2024-11-06,100,@,HOU,L 100-127,240,37,83,0.446,23,47,0.489,14,36,0.389,12,16,0.75,100,54,96,0.563,44,69,0.638,10,27,0.37,9,15,0.6,127
351,NOP,2024-11-04,100,,POR,L 100-118,240,38,84,0.452,28,49,0.571,10,35,0.286,14,16,0.875,100,46,84,0.548,36,55,0.655,10,29,0.345,16,24,0.667,118
352,NOP,2024-11-16,99,,LAL,L 99-104,240,35,83,0.422,24,54,0.444,11,29,0.379,18,23,0.783,99,39,89,0.438,27,49,0.551,12,40,0.3,14,18,0.778,104
353,OKC,2024-11-15,99,,PHO,W 99-83,240,36,91,0.396,26,51,0.51,10,40,0.25,17,18,0.944,99,22,75,0.293,13,38,0.342,9,37,0.243,30,40,0.75,83
354,DET,2024-11-15,99,@,TOR,W 99-95,240,39,95,0.411,31,57,0.544,8,38,0.211,13,20,0.65,99,35,97,0.361,27,66,0.409,8,31,0.258,17,22,0.773,95
355,PHI,2024-11-12,99,,NYK,L 99-111,240,31,83,0.373,17,41,0.415,14,42,0.333,23,24,0.958,99,44,89,0.494,35,58,0.603,9,31,0.29,14,15,0.933,111
356,MIL,2024-11-12,99,,TOR,W 99-85,240,38,94,0.404,22,38,0.579,16,56,0.286,7,12,0.583,99,30,86,0.349,21,61,0.344,9,25,0.36,16,20,0.8,85
357,DET,2024-11-10,99,,HOU,L 99-101,240,36,84,0.429,25,50,0.5,11,34,0.324,16,23,0.696,99,38,93,0.409,31,59,0.525,7,34,0.206,18,24,0.75,101
358,CHI,2024-11-06,99,@,DAL,L 99-119,240,36,86,0.419,24,44,0.545,12,42,0.286,15,23,0.652,99,45,93,0.484,33,55,0.6,12,38,0.316,17,21,0.81,119
359,MIL,2024-10-31,99,@,MEM,L 99-122,240,41,96,0.427,32,54,0.593,9,42,0.214,8,19,0.421,99,43,82,0.524,35,54,0.648,8,28,0.286,28,31,0.903,122
360,ORL,2024-10-30,99,@,CHI,L 99-102,240,35,86,0.407,24,40,0.6,11,46,0.239,18,20,0.9,99,36,84,0.429,23,50,0.46,13,34,0.382,17,25,0.68,102
361,ORL,2024-11-15,98,,PHI,W 98-86,240,34,78,0.436,23,41,0.561,11,37,0.297,19,22,0.864,98,29,72,0.403,19,41,0.463,10,31,0.323,18,21,0.857,86
362,MIN,2024-11-13,98,@,POR,L 98-106,240,37,94,0.394,30,55,0.545,7,39,0.179,17,22,0.773,98,38,83,0.458,29,58,0.5,9,25,0.36,21,23,0.913,106
363,SAC,2024-11-08,98,,LAC,L 98-107,240,37,78,0.474,34,52,0.654,3,26,0.115,21,24,0.875,98,36,81,0.444,22,51,0.431,14,30,0.467,21,23,0.913,107
364,PHI,2024-11-06,98,@,LAC,L 98-110,240,40,73,0.548,33,48,0.688,7,25,0.28,11,19,0.579,98,41,72,0.569,29,44,0.659,12,28,0.429,16,19,0.842,110
365,WAS,2024-11-02,98,,MIA,L 98-118,240,38,91,0.418,31,56,0.554,7,35,0.2,15,21,0.714,98,43,102,0.422,28,65,0.431,15,37,0.405,17,24,0.708,118
366,DET,2024-11-01,98,,NYK,L 98-128,240,41,81,0.506,30,47,0.638,11,34,0.324,5,7,0.714,98,52,101,0.515,34,63,0.54,18,38,0.474,6,10,0.6,128
367,POR,2024-10-28,98,@,SAC,L 98-111,240,35,83,0.422,31,61,0.508,4,22,0.182,24,30,0.8,98,37,81,0.457,23,46,0.5,14,35,0.4,23,25,0.92,111
368,DET,2024-10-28,98,@,MIA,L 98-106,240,35,91,0.385,21,53,0.396,14,38,0.368,14,17,0.824,98,38,88,0.432,23,41,0.561,15,47,0.319,15,20,0.75,106
369,IND,2024-10-25,98,@,NYK,L 98-123,240,41,83,0.494,38,53,0.717,3,30,0.1,13,20,0.65,98,44,84,0.524,32,57,0.561,12,27,0.444,23,29,0.793,123
370,NYK,2024-11-04,97,@,HOU,L 97-109,240,34,88,0.386,23,60,0.383,11,28,0.393,18,21,0.857,97,43,88,0.489,35,55,0.636,8,33,0.242,15,18,0.833,109
371,POR,2024-11-02,97,@,PHO,L 97-103,240,37,111,0.333,23,68,0.338,14,43,0.326,9,11,0.818,97,35,93,0.376,18,41,0.439,17,52,0.327,16,22,0.727,103
372,MIA,2024-10-23,97,,ORL,L 97-116,240,32,82,0.39,21,48,0.438,11,34,0.324,22,29,0.759,97,41,96,0.427,23,47,0.489,18,49,0.367,16,22,0.727,116
373,SAC,2024-11-11,96,@,SAS,L 96-116,240,39,91,0.429,29,53,0.547,10,38,0.263,8,9,0.889,96,43,85,0.506,21,39,0.538,22,46,0.478,8,8,1,116
374,UTA,2024-10-29,96,,SAC,L 96-113,240,35,89,0.393,21,41,0.512,14,48,0.292,12,14,0.857,96,48,92,0.522,40,61,0.656,8,31,0.258,9,14,0.643,113
375,TOR,2024-11-15,95,,DET,L 95-99,240,35,97,0.361,27,66,0.409,8,31,0.258,17,22,0.773,95,39,95,0.411,31,57,0.544,8,38,0.211,13,20,0.65,99
376,MIA,2024-11-10,95,@,MIN,W 95-94,240,34,77,0.442,23,46,0.5,11,31,0.355,16,22,0.727,95,35,88,0.398,22,43,0.512,13,45,0.289,11,13,0.846,94
377,PHI,2024-10-30,95,,DET,L 95-105,240,33,79,0.418,25,51,0.49,8,28,0.286,21,28,0.75,95,36,78,0.462,21,42,0.5,15,36,0.417,18,22,0.818,105
378,CHI,2024-10-26,95,,OKC,L 95-114,240,32,92,0.348,17,39,0.436,15,53,0.283,16,22,0.727,95,45,107,0.421,37,67,0.552,8,40,0.2,16,20,0.8,114
379,DEN,2024-11-15,94,@,NOP,L 94-101,240,37,87,0.425,27,50,0.54,10,37,0.27,10,11,0.909,94,37,87,0.425,26,52,0.5,11,35,0.314,16,18,0.889,101
380,ORL,2024-11-13,94,,IND,W 94-90,240,34,84,0.405,21,46,0.457,13,38,0.342,13,15,0.867,94,32,84,0.381,22,54,0.407,10,30,0.333,16,18,0.889,90
381,WAS,2024-11-10,94,@,ORL,L 94-121,240,33,72,0.458,23,39,0.59,10,33,0.303,18,25,0.72,94,41,91,0.451,24,43,0.558,17,48,0.354,22,25,0.88,121
382,MIN,2024-11-10,94,,MIA,L 94-95,240,35,88,0.398,22,43,0.512,13,45,0.289,11,13,0.846,94,34,77,0.442,23,46,0.5,11,31,0.355,16,22,0.727,95
383,MIL,2024-11-08,94,@,NYK,L 94-116,240,36,83,0.434,29,53,0.547,7,30,0.233,15,23,0.652,94,43,91,0.473,29,45,0.644,14,46,0.304,16,19,0.842,116
384,SAS,2024-11-16,93,@,DAL,L 93-110,240,28,88,0.318,17,48,0.354,11,40,0.275,26,30,0.867,93,44,94,0.468,36,63,0.571,8,31,0.258,14,18,0.778,110
385,CHO,2024-11-04,93,@,MIN,L 93-114,240,35,88,0.398,25,46,0.543,10,42,0.238,13,16,0.813,93,39,79,0.494,21,41,0.512,18,38,0.474,18,26,0.692,114
386,ATL,2024-11-04,93,,BOS,L 93-123,240,37,89,0.416,31,58,0.534,6,31,0.194,13,16,0.813,93,48,99,0.485,30,44,0.682,18,55,0.327,9,13,0.692,123
387,SAS,2024-10-30,93,@,OKC,L 93-105,240,35,85,0.412,23,49,0.469,12,36,0.333,11,13,0.846,93,41,89,0.461,24,48,0.5,17,41,0.415,6,8,0.75,105
388,WAS,2024-11-11,92,@,HOU,L 92-107,240,36,88,0.409,25,57,0.439,11,31,0.355,9,13,0.692,92,40,87,0.46,35,64,0.547,5,23,0.217,22,25,0.88,107
389,BRK,2024-11-03,92,,DET,L 92-106,240,32,71,0.451,23,40,0.575,9,31,0.29,19,31,0.613,92,37,77,0.481,26,41,0.634,11,36,0.306,21,26,0.808,106
390,LAC,2024-11-02,92,,OKC,L 92-105,240,32,79,0.405,21,44,0.477,11,35,0.314,17,26,0.654,92,36,84,0.429,20,45,0.444,16,39,0.41,17,19,0.895,105
391,DEN,2024-11-17,90,@,MEM,L 90-105,240,35,84,0.417,25,53,0.472,10,31,0.323,10,14,0.714,90,41,91,0.451,28,52,0.538,13,39,0.333,10,12,0.833,105
392,IND,2024-11-13,90,@,ORL,L 90-94,240,32,84,0.381,22,54,0.407,10,30,0.333,16,18,0.889,90,34,84,0.405,21,46,0.457,13,38,0.342,13,15,0.867,94
393,CHO,2024-11-12,89,@,ORL,L 89-114,240,34,84,0.405,21,46,0.457,13,38,0.342,8,14,0.571,89,43,93,0.462,30,49,0.612,13,44,0.295,15,19,0.789,114
394,POR,2024-11-10,89,,MEM,L 89-134,240,34,100,0.34,30,58,0.517,4,42,0.095,17,21,0.81,89,47,85,0.553,31,42,0.738,16,43,0.372,24,28,0.857,134
395,NOP,2024-10-30,89,@,GSW,L 89-104,240,33,90,0.367,22,54,0.407,11,36,0.306,12,20,0.6,89,41,87,0.471,28,49,0.571,13,38,0.342,9,13,0.692,104
396,NOP,2024-11-13,88,@,OKC,L 88-106,240,34,86,0.395,25,49,0.51,9,37,0.243,11,17,0.647,88,39,88,0.443,24,49,0.49,15,39,0.385,13,16,0.813,106
397,NOP,2024-11-08,88,@,ORL,L 88-115,240,32,84,0.381,22,53,0.415,10,31,0.323,14,17,0.824,88,45,86,0.523,37,54,0.685,8,32,0.25,17,21,0.81,115
398,UTA,2024-10-31,88,,SAS,L 88-106,240,32,82,0.39,25,50,0.5,7,32,0.219,17,19,0.895,88,38,92,0.413,26,49,0.531,12,43,0.279,18,23,0.783,106
399,DEN,2024-10-24,87,,OKC,L 87-102,240,35,98,0.357,28,60,0.467,7,38,0.184,10,14,0.714,87,43,101,0.426,35,65,0.538,8,36,0.222,8,12,0.667,102
400,PHI,2024-11-15,86,@,ORL,L 86-98,240,29,72,0.403,19,41,0.463,10,31,0.323,18,21,0.857,86,34,78,0.436,23,41,0.561,11,37,0.297,19,22,0.864,98
401,ORL,2024-11-04,86,@,OKC,L 86-102,240,29,82,0.354,24,48,0.5,5,34,0.147,23,27,0.852,86,39,85,0.459,27,54,0.5,12,31,0.387,12,16,0.75,102
402,UTA,2024-10-25,86,,GSW,L 86-127,240,29,92,0.315,20,50,0.4,9,42,0.214,19,26,0.731,86,51,106,0.481,31,56,0.554,20,50,0.4,5,6,0.833,127
403,TOR,2024-11-12,85,@,MIL,L 85-99,240,30,86,0.349,21,61,0.344,9,25,0.36,16,20,0.8,85,38,94,0.404,22,38,0.579,16,56,0.286,7,12,0.583,99
404,ORL,2024-11-03,85,@,DAL,L 85-108,240,31,93,0.333,23,52,0.442,8,41,0.195,15,19,0.789,85,42,85,0.494,32,53,0.604,10,32,0.313,14,23,0.609,108
405,PHO,2024-11-15,83,@,OKC,L 83-99,240,22,75,0.293,13,38,0.342,9,37,0.243,30,40,0.75,83,36,91,0.396,26,51,0.51,10,40,0.25,17,18,0.944,99
406,IND,2024-11-08,83,@,CHO,L 83-103,240,33,83,0.398,24,54,0.444,9,29,0.31,8,14,0.571,83,38,90,0.422,21,40,0.525,17,50,0.34,10,12,0.833,103
